org_name	org_url
Safe Places Little Rock	/org/safe-places-little-rock
Arkansas Rice Depot, Inc.	/org/arkansas-rice-depot-inc
Rock City Rescue	/org/rock-city-rescue
Heifer Project International, Inc.	/org/heifer-project-international-inc
Environmental and Spatial Technology Inc	/org/environmental-and-spatial-technology-inc
Shepherds Fold Ministry Inc	/org/shepherds-fold-ministry-inc
Jones Center For Families Inc	/org/jones-center-for-families-inc
Arkansans for Animals Inc	/org/arkansans-for-animals-inc
Arkansas Search Dog Association Inc	/org/arkansas-search-dog-association-inc
Oaxaca Street Children Grassroots, Inc.	/org/oaxaca-street-children-grassroots-inc
Ouachita Calhoun Counties Literacy Council	/org/ouachita-calhoun-counties-literacy-council
Southern States Rescued Rottweilers Inc	/org/southern-states-rescued-rottweilers-inc
Garland County Animal Welfare Association Inc d/b/a Humane Society of Garland County	/org/garland-county-animal-welfare-association-inc
Arkansas Single Parent Scholarship Fund, Inc	/org/arkansas-single-parent-scholarship-fund-inc
Arkansas Heart Foundation	/org/arkansas-heart-foundation
Women & Children First the Center Against Family Violence	/org/women-children-first-the-center-against-family-violence
Columbia County Animal Protection Society Inc	/org/columbia-county-animal-protection-society-inc
Cancer Charity4 Life Inc.	/org/cancer-charity4-life-inc
Ozark Homeward Bound	/org/ozark-homeward-bound
Stray Central	/org/stray-central
The William J Clinton Foundation	/org/the-william-j-clinton-foundation
Arkansas Women In Agriculture Inc	/org/arkansas-women-in-agriculture-inc
Samaritan House Community Center	/org/samaritan-house-community-center
Arkansas Sheriffs Youth Ranches Inc	/org/arkansas-sheriffs-youth-ranches-inc
Heifer International Foundation	/org/heifer-international-foundation
Temple Shalom Of Northwest Arkansas	/org/temple-shalom-of-northwest-arkansas
Good Samaritan Ministries	/org/good-samaritan-ministries
Mid-America Science Museum	/org/mid-america-science-museum
Turpentine Creek Foundation Inc	/org/turpentine-creek-foundation-inc
Single Parent Scholarship Fund Of Pulaski County	/org/single-parent-scholarship-fund-of-pulaski-county
The Arc for River Valley	/org/the-arc-for-river-valley
WAL-MART ASSOCIATES IN CRITICAL NEED FUND	/org/wal-mart-associates-in-critical-need-fund
Critter Holler Animal Rescue	/org/critter-holler-animal-rescue
Teen Recruiters	/org/teen-recruiters
Hot Springs Village Animal Welfare League Inc	/org/hot-springs-village-animal-welfare-league-inc
Lupus Foundation of  Arkansas , Inc.	/org/lupus-foundation-of-arkansas-inc
Suzuki Institute For Musical Training, Inc.	/org/suzuki-institute-for-musical-training-inc
Dyaln's Closet	/org/dyalns-closet
Life Skills For Youth	/org/life-skills-for-youth
Project 180, Inc.	/org/project-180-inc-2
Rescue Road	/org/rescue-road
Stop Animal Cruelty In Hot Spring County Arkansas Inc	/org/stop-animal-cruelty-in-hot-spring-county-arkansas-inc
FRIENDSHIP COMMUNITY CARE INC	/org/friendship-community-care-inc
Arkansas Community Foundation, Inc.	/org/arkansas-community-foundation-inc
Champions For Kids	/org/champions-for-kids
STEPHENS EDUCATIONAL PROGRAM	/org/stephens-educational-program
Sheep Dog Impact Assistance	/org/sheep-dog-impact-assistance
UNION RESCUE MISSION INC	/org/union-rescue-mission-inc
Lyon College	/org/lyon-college
Feline Rescue And Rehome Inc	/org/feline-rescue-and-rehome-inc
Baca Of Arkansas	/org/baca-of-arkansas
The Southern Delta Church of Wicca	/org/the-southern-delta-church-of-wicca
THRIVE INC	/org/thrive-inc-1
Impact 360	/org/impact-360
Taters Ark Animal Welfare Fund Inc	/org/taters-ark-animal-welfare-fund-inc
GIVE ME A CHANCE EQUINE RESCUE	/org/give-me-a-chance-equine-rescue
Boys And Girls Club Of Faulkner County Arkansas Inc	/org/boys-and-girls-club-of-faulkner-county-arkansas-inc
World Services For The Blind Incorporated	/org/world-services-for-the-blind-incorporated
Arkansas Foodbank	/org/arkansas-foodbank
A Home In Haiti Inc	/org/a-home-in-haiti-inc
Forrest City Area Humane Society	/org/forrest-city-area-humane-society
Fountain of Youth Adult Day Center	/org/fountain-of-youth-adult-day-center
The Ivy Center For Education Inc	/org/the-ivy-center-for-education-inc
Central Arkansas Spca	/org/central-arkansas-spca
Parents Of Murdered Children	/org/parents-of-murdered-children-45
Saints Taking A New Direction Inc	/org/saints-taking-a-new-direction-inc
Meadowbrook Community Outreach Program	/org/meadowbrook-community-outreach-program
LITERACY COUNCIL OF WHITE COUNTY	/org/literacy-council-of-white-county
Conway United Soccer Association	/org/conway-united-soccer-association
Sources For Community Independent Living Services	/org/sources-for-community-independent-living-services
Circle Of Life Hospice Foundation	/org/circle-of-life-hospice-foundation-1
Hope For The Young	/org/hope-for-the-young
Fraternal Order Of Police	/org/fraternal-order-of-police-1206
Victory Walk Inc	/org/victory-walk-inc
End Time Handmaidens Inc	/org/end-time-handmaidens-inc
Congregation Etz Chaim Of Northwest Arkansas	/org/congregation-etz-chaim-of-northwest-arkansas
Saving Grace	/org/saving-grace-1
Northwest Arkansas Land Trust	/org/northwest-arkansas-land-trust
Lonoke County Task Force On Child Abuse And Neglect Inc	/org/lonoke-county-task-force-on-child-abuse-and-neglect-inc
White Cell Inc	/org/white-cell-inc
Fort Smith Montesorri School Inc	/org/fort-smith-montesorri-school-inc
Humane Society Of Pulaski County	/org/humane-society-of-pulaski-county
Heber Springs Humane Society	/org/heber-springs-humane-society
Godfrey Thomas Foundation Inc	/org/godfrey-thomas-foundation-inc
Mays Mission For The Handicapped Inc	/org/mays-mission-for-the-handicapped-inc
Northwest Arkansas Radiation Therapy Institute	/org/northwest-arkansas-radiation-therapy-institute
Spiritual Concepts International	/org/spiritual-concepts-international
Reeds Bridge Battlefield Preservation Society Inc	/org/reeds-bridge-battlefield-preservation-society-inc
ARKANSAS RESCUING UNWANTED FURRY FRIENDS	/org/arkansas-rescuing-unwanted-furry-friends
Oasis Of Northwest Arkansas	/org/oasis-of-northwest-arkansas
Forestine Smith Ministries	/org/forestine-smith-ministries
Rockin Aa Sanctuary Inc	/org/rockin-aa-sanctuary-inc
Arkansas Support Network Inc	/org/arkansas-support-network-inc
NAMI-ARKANSAS	/org/nami-arkansas
Health Talents International Inc	/org/health-talents-international-inc
Paragould Goodfellows Inc	/org/paragould-goodfellows-inc
El Dorado Boys Club Foundation	/org/el-dorado-boys-club-foundation
Dee Cash Ministries	/org/dee-cash-ministries
Arkansas Regional Organ Recovery Agency Inc	/org/arkansas-regional-organ-recovery-agency-inc
United Cerebral Palsy of Central Arkansas, Inc.	/org/united-cerebral-palsy-of-central-arkansas-inc
National Center For Fathering	/org/national-center-for-fathering
Youth Bridge Inc	/org/youth-bridge-inc
EUREKA KIDS	/org/eureka-kids
Eastern Arkansas Ballet Inc	/org/eastern-arkansas-ballet-inc
CASA,Court Appointed Special Advocates of the 2nd Judicial District-Arkansas	/org/casa-court-appointed-special-advocates-of-the-2nd-judicial-district-arkansa
GENTLE SOULS PIT BULL RESCUE	/org/gentle-souls-pit-bull-rescue
Our House Inc	/org/our-house-inc-6
Omni Center For Peace Justice And Ecology	/org/omni-center-for-peace-justice-and-ecology
Tender Heart Wildlife Rehabilitation Inc	/org/tender-heart-wildlife-rehabilitation-inc
Arkansas Living History Association	/org/arkansas-living-history-association
Fistula Relief Foundation For Africa	/org/fistula-relief-foundation-for-africa
Gods Feeding Hands	/org/gods-feeding-hands
Butterfly Kisses Outreach	/org/butterfly-kisses-outreach
Lonoke County Animal Education And Rescue Team	/org/lonoke-county-animal-education-and-rescue-team
Alis Angels Foundation Inc	/org/alis-angels-foundation-inc
Goodwill Industries of Arkansas, Inc.	/org/goodwill-industries-of-arkansas-inc
Ozark Natural Science Center Inc	/org/ozark-natural-science-center-inc
Degray Rural Fire Department	/org/degray-rural-fire-department
Hot Springs Documentary Film Institute	/org/hot-springs-documentary-film-institute
Child Abuse Awareness Inc	/org/child-abuse-awareness-inc
Grace Lutheran Church	/org/grace-lutheran-church-273
General Council Of The Assemblies Of God	/org/general-council-of-the-assemblies-of-god-201
Literacy Council Of Western Arkansas Inc	/org/literacy-council-of-western-arkansas-inc
United Daughters Of The Confederacy	/org/united-daughters-of-the-confederacy-11
Souls Harbor Church	/org/souls-harbor-church
Messiah Ministries Inc	/org/messiah-ministries-inc
East Oak Place	/org/east-oak-place
Arkansas Broadcasting Foundation	/org/arkansas-broadcasting-foundation
Boys & Girls Club Of Jefferson County	/org/boys-girls-club-of-jefferson-county-1
Southwest Arkansas Food Bank Incorporated	/org/southwest-arkansas-food-bank-incorporated
Northwest Arkansas Academic Competition Association	/org/northwest-arkansas-academic-competition-association
Mount Zion Presbytarian Cemetery Association	/org/mount-zion-presbytarian-cemetery-association
Central Christian College Inc	/org/central-christian-college-inc
Life Of Faith Christian Fellowship Inc	/org/life-of-faith-christian-fellowship-inc
Ozark Interpretive Association Inc	/org/ozark-interpretive-association-inc
Our Savior Lutheran Church	/org/our-savior-lutheran-church-154
Youth Advocates & Resource Network Inc	/org/youth-advocates-resource-network-inc
Centro Cristiano Hispano	/org/centro-cristiano-hispano
Associated Brotherhood Of Christians	/org/associated-brotherhood-of-christians-16
Japanese Saturday School Of Little Rock, Inc.	/org/japanese-saturday-school-of-little-rock-inc
Southern Arkansas Transportation Co	/org/southern-arkansas-transportation-co
United Daughters Of The Confederacy	/org/united-daughters-of-the-confederacy-10
Anthony School Support Group Inc	/org/anthony-school-support-group-inc
Des Arc Baseball Association Inc	/org/des-arc-baseball-association-inc
Jesus New Covenant Church Of Texarkana Arkansas	/org/jesus-new-covenant-church-of-texarkana-arkansas
Friends Of Devils Den State Park Inc	/org/friends-of-devils-den-state-park-inc
South Arkansas Fights Aids	/org/south-arkansas-fights-aids
Mt Calvary Church Of God In Christ Inc	/org/mt-calvary-church-of-god-in-christ-inc
Pta Arkansas Congress	/org/pta-arkansas-congress_15606
Arkansas Midwives School And Services	/org/arkansas-midwives-school-and-services
Pta Arkansas Congress	/org/pta-arkansas-congress_15604
Community Housing Of Little Rock Inc	/org/community-housing-of-little-rock-inc
North Arkansas Regional Medical Center	/org/north-arkansas-regional-medical-center
Cooperative Emergency Outreach	/org/cooperative-emergency-outreach
International Reading Association Inc	/org/international-reading-association-inc-31
Ward Family Singers & Gospel Music Society Inc	/org/ward-family-singers-gospel-music-society-inc
Altrusa International Foundation Inc	/org/altrusa-international-foundation-inc
Elizabeth Mcgill Drop-In Center Inc	/org/elizabeth-mcgill-drop-in-center-inc
Cystic Fibrosis Foundation	/org/cystic-fibrosis-foundation_15490
Tourette Syndrome Assoc Inc	/org/tourette-syndrome-assoc-inc
Associated Brotherhood Of Christians	/org/associated-brotherhood-of-christians
Womens International Bowling Congress Inc	/org/womens-international-bowling-congress-inc_5987
Community Development Corp Of Bentonville Bella Vista	/org/community-development-corp-of-bentonville-bella-vista
General Council Of The Assemblies Of God	/org/general-council-of-the-assemblies-of-god_15714
Arkansas Recycling Coalition Inc	/org/arkansas-recycling-coalition-inc
Tomberlin Community Development Center Corporation Inc	/org/tomberlin-community-development-center-corporation-inc
Human Development & Research Services Inc	/org/human-development-research-services-inc
In His Name Inc	/org/in-his-name-inc
Western Arkansas Regional Management Services Inc	/org/western-arkansas-regional-management-services-inc
OZARK MOUNTAIN ALCOHOL RESIDENTIAL TREATMENT INC	/org/ozark-mountain-alcohol-residential-treatment-inc
Henderson State University Foundation	/org/henderson-state-university-foundation
Arkansas Tech University Foundation	/org/arkansas-tech-university-foundation
Twin River Community Living Facility Inc	/org/twin-river-community-living-facility-inc
Senior Citizens Outreach Services Inc	/org/senior-citizens-outreach-services-inc
Montgomery County Health Education Advisory Board Inc	/org/montgomery-county-health-education-advisory-board-inc
The Junior Civic League Red Stocking Revue	/org/the-junior-civic-league-red-stocking-revue
World Ministries Inc	/org/world-ministries-inc
Ronald Mcdonald House Charities Of Arkansas Inc	/org/ronald-mcdonald-house-charities-of-arkansas-inc
Cedar Mountain Ambulance Inc	/org/cedar-mountain-ambulance-inc
Western Arkansas Employment Development Agency Inc	/org/western-arkansas-employment-development-agency-inc
Armsdc Inc	/org/armsdc-inc
Cooper Assembly Of God	/org/cooper-assembly-of-god
Paces Inc	/org/paces-inc
Hendrix-Murphy Foundation Inc	/org/hendrix-murphy-foundation-inc
West Memphis Baptist Church	/org/west-memphis-baptist-church
Buffalo Island Ems Ambulance, Inc.	/org/buffalo-island-ems-ambulance-inc
Ouachita Christian Academy, Inc.	/org/ouachita-christian-academy-inc
Arkansans For Gifted And Talented Education	/org/arkansans-for-gifted-and-talented-education
Ozark Legal Services	/org/ozark-legal-services
Auxiliary To St Bernards Regional Medical Center	/org/auxiliary-to-st-bernards-regional-medical-center
Fred Moore Memorial Student Loan Fund Inc	/org/fred-moore-memorial-student-loan-fund-inc
Community Bible Church	/org/community-bible-church
Ouachita Childrens Center Inc	/org/ouachita-childrens-center-inc
St Josephs Guild	/org/st-josephs-guild
Fellowship Bible Church Of Little Rock	/org/fellowship-bible-church-of-little-rock
Mid-America Institute For Human Advancement Inc	/org/mid-america-institute-for-human-advancement-inc
Ballet Arkansas	/org/ballet-arkansas
Pentecostal Deliverance Association	/org/pentecostal-deliverance-association
Area Agency On Aging Of Southeast Arkansas Inc	/org/area-agency-on-aging-of-southeast-arkansas-inc
Area Agency On Aging Of West Centra Arkansas Inc	/org/area-agency-on-aging-of-west-centra-arkansas-inc
The Doni Martin Center For Developmental Services Inc	/org/the-doni-martin-center-for-developmental-services-inc
Van Buren County Special School	/org/van-buren-county-special-school
Civil Air Patrol, Inc.	/org/civil-air-patrol-inc_72181
Ouachita Industries Inc	/org/ouachita-industries-inc
The New School	/org/the-new-school-1
Pattillo Center-School Inc	/org/pattillo-center-school-inc
Boone County Special Services Inc	/org/boone-county-special-services-inc
Baptist Health	/org/baptist-health
First Christian Church	/org/first-christian-church-655
Camp Fire	/org/camp-fire-21
Teen Age Club	/org/teen-age-club
Ymca Of Greater Jonesboro	/org/ymca-of-greater-jonesboro
Boys & Girls Club Of El Dorado	/org/boys-girls-club-of-el-dorado
First Assembly Of God	/org/first-assembly-of-god-653
Sebastian Humane Society	/org/sebastian-humane-society
Central Arkansas Opportunity Foundation Trust	/org/central-arkansas-opportunity-foundation-trust
Delta Fellowship Church Inc	/org/delta-fellowship-church-inc
Child Life International Inc	/org/child-life-international-inc
Jonestown Community Association	/org/jonestown-community-association
11809 Hinson Road Owners Assoc Inc	/org/11809-hinson-road-owners-assoc-inc
Family Center Inc	/org/family-center-inc
Pine Bluff Composite Squadron	/org/pine-bluff-composite-squadron
Nashville Christian Academy Inc	/org/nashville-christian-academy-inc
Cooperative Christian Ministries And Clinic	/org/cooperative-christian-ministries-and-clinic
Sowers Of The Harvest	/org/sowers-of-the-harvest
Quail Unlimited, Inc.	/org/quail-unlimited-inc_20869
Heritage Square Apartments Inc	/org/heritage-square-apartments-inc
Winthrop Pta	/org/winthrop-pta
Volunteer Council Arkadelphia Human Development Center Inc	/org/volunteer-council-arkadelphia-human-development-center-inc
World Missions Today	/org/world-missions-today
Wear & Share Inc	/org/wear-share-inc
South Arkansas Arts Center	/org/south-arkansas-arts-center
The Baptist Preparatory School	/org/the-baptist-preparatory-school
Arkloma Chapter Of The American Institute Of Banking	/org/arkloma-chapter-of-the-american-institute-of-banking
Arkansas For The Developmentally Disabled	/org/arkansas-for-the-developmentally-disabled
Little League Baseball, Inc.	/org/little-league-baseball-inc-229
South Arkansas Livestock Show Association	/org/south-arkansas-livestock-show-association
American Amputee Foundation Inc	/org/american-amputee-foundation-inc
Lords Ranch Christian Center And Childrens Rehabilitation Unit Inc	/org/lords-ranch-christian-center-and-childrens-rehabilitation-unit-inc
Bismarck Fire Protection Assn Inc	/org/bismarck-fire-protection-assn-inc
Trinity Pentecostal Church Of Hackett Inc	/org/trinity-pentecostal-church-of-hackett-inc
Jackson County Housing Inc	/org/jackson-county-housing-inc
Newport Montessori School Inc	/org/newport-montessori-school-inc
Partners For Pinnacle Inc	/org/partners-for-pinnacle-inc
Fort Smith Regional Air Show Inc	/org/fort-smith-regional-air-show-inc
Arkansas Rural Endowment Fund Inc	/org/arkansas-rural-endowment-fund-inc
Free Hill Full Gospel Church	/org/free-hill-full-gospel-church
Housing Authority Of Tyronza	/org/housing-authority-of-tyronza
Russellville Heritage Apartments Inc	/org/russellville-heritage-apartments-inc
Conway Inter-Church Housing Inc	/org/conway-inter-church-housing-inc
The Potters House	/org/the-potters-house
Robins Nest Daycare And Learning Center, Inc.	/org/robins-nest-daycare-and-learning-center-inc
Promise Land Bible Church	/org/promise-land-bible-church
The Storehouse Of Love Ministries Incorporated	/org/the-storehouse-of-love-ministries-incorporated
East Ark Inc	/org/east-ark-inc
First Assembly Of God	/org/first-assembly-of-god-637
Gartrell High School Alumni Associa Tion	/org/gartrell-high-school-alumni-associa-tion
Presbyterian Development Corporat	/org/presbyterian-development-corporat
Stuttgart Memorial Hospital Foundation	/org/stuttgart-memorial-hospital-foundation
43 Assembly Of God	/org/43-assembly-of-god
Pangburn First Ag	/org/pangburn-first-ag
Peace Lutheran Church	/org/peace-lutheran-church-146
Little Rock Community Mental Health Center Inc	/org/little-rock-community-mental-health-center-inc
Committee Against Spouse Abuse Inc	/org/committee-against-spouse-abuse-inc
Arkansas East Bolivia Partners Of The Americans	/org/arkansas-east-bolivia-partners-of-the-americans
Pta Arkansas Congress	/org/pta-arkansas-congress_15579
Road Runners Club Of America	/org/road-runners-club-of-america-592
St. Vincent Homecare	/org/st-vincent-homecare
Ronald Mcdonald House Charities, Inc.	/org/ronald-mcdonald-house-charities-inc_15577
Mid Marion County Rotary Foundation Inc	/org/mid-marion-county-rotary-foundation-inc
James C Dunbar Trust	/org/james-c-dunbar-trust
Antioch Volunteer Fire Department Inc	/org/antioch-volunteer-fire-department-inc
Spiritual Assembly Of The Bahais Of Springdale	/org/spiritual-assembly-of-the-bahais-of-springdale
Saints Temple Cogic	/org/saints-temple-cogic
Quail Unlimited, Inc.	/org/quail-unlimited-inc_25871
Alt Consulting	/org/alt-consulting
First Assembly Of God Church	/org/first-assembly-of-god-church-67
Synergy Forum Inc	/org/synergy-forum-inc
Service Corps Of Retired Executives Association	/org/service-corps-of-retired-executives-association_26296
American Inns Of Court Foundation	/org/american-inns-of-court-foundation-253
National Association Of Housing & Redevelopment Officials	/org/national-association-of-housing-redevelopment-officials-16
National Explosive Ordinance Disposal Association Inc	/org/national-explosive-ordinance-disposal-association-inc
American Association Of Family And Consumer Sciences	/org/american-association-of-family-and-consumer-sciences-19
Womens International Bowling Congress	/org/womens-international-bowling-congress_27983
Womens International Bowling Congress Inc	/org/womens-international-bowling-congress-inc_27993
Redfield Volunteer Fire Association	/org/redfield-volunteer-fire-association
Fort Smith Bible Church	/org/fort-smith-bible-church
The White County Fair Association Incorporated	/org/the-white-county-fair-association-incorporated
Womens International Bowling Congress Inc	/org/womens-international-bowling-congress-inc_30300
Candlelight Ministry	/org/candlelight-ministry
Association Of Programs For Rural Independent Living	/org/association-of-programs-for-rural-independent-living
Phi Upsilon Omicron Inc	/org/phi-upsilon-omicron-inc-63
Sons Of The American Revolution	/org/sons-of-the-american-revolution_41574
Living Way Apostolic Evangelistic Ministries Inc	/org/living-way-apostolic-evangelistic-ministries-inc
Muslim Students Assoc Of Us & Canada	/org/muslim-students-assoc-of-us-canada_41918
American Society Of Agricultural Engineers	/org/american-society-of-agricultural-engineers-31
Future Homemakers Of America, Inc. Mcrae Hs	/org/future-homemakers-of-america-inc-mcrae-hs
Arkansas League Of Artists	/org/arkansas-league-of-artists
Symphony Orchestra Of Northwest Arkansas	/org/symphony-orchestra-of-northwest-arkansas
Community Concerts Of Greater Little Rock	/org/community-concerts-of-greater-little-rock
Junior Auxillary Of Jonesboro Arkansas Inc	/org/junior-auxillary-of-jonesboro-arkansas-inc
Jacksonville Junior Auxiliary	/org/jacksonville-junior-auxiliary
Big Brothers Of Pulaski County Foundation Inc	/org/big-brothers-of-pulaski-county-foundation-inc
Our Way Inc	/org/our-way-inc
Trinity Village Inc	/org/trinity-village-inc
Searcy Junior Auxiliary Inc	/org/searcy-junior-auxiliary-inc
Upper Friley Organization School Inc	/org/upper-friley-organization-school-inc
Project Compassion Inc	/org/project-compassion-inc-1
American Orthodox Catholic Church Of Arkansas Inc	/org/american-orthodox-catholic-church-of-arkansas-inc
South Arkansas Symphony Society	/org/south-arkansas-symphony-society
Sons Of The American Revolution	/org/sons-of-the-american-revolution_46521
Medical Education Foundation For Arkansas	/org/medical-education-foundation-for-arkansas
Arkansas Extension Homemakers Council	/org/arkansas-extension-homemakers-council_46734
Arkansas Extension Homemakers Council	/org/arkansas-extension-homemakers-council-327
Arkansas Extension Homemakers Council	/org/arkansas-extension-homemakers-council-320
Arkansas Extension Homemakers Council	/org/arkansas-extension-homemakers-council-309
Arkansas Extension Homemakers Council	/org/arkansas-extension-homemakers-council-300
National Dunbar Alumni Association Of Little Rock Arkansas Inc	/org/national-dunbar-alumni-association-of-little-rock-arkansas-inc
Christians Incorporated For Christ	/org/christians-incorporated-for-christ
International Church Of The Foursquare Gospel	/org/international-church-of-the-foursquare-gospel-176
National Association Of Miniature Enthusiasts	/org/national-association-of-miniature-enthusiasts_60315
Mobile Tabernacle Ministries	/org/mobile-tabernacle-ministries
Women's Aglow Fellowship	/org/womens-aglow-fellowship_61913
Women's Aglow Fellowship	/org/womens-aglow-fellowship_61945
Women's Aglow Fellowship	/org/womens-aglow-fellowship_61998
Women's Aglow Fellowship	/org/womens-aglow-fellowship_62097
Women's Aglow Fellowship	/org/womens-aglow-fellowship_62098
International Church Of The Foursquare Gospel	/org/international-church-of-the-foursquare-gospel_62315
Bahais Of Mountain View	/org/bahais-of-mountain-view
Ramah International Inc	/org/ramah-international-inc
Christian Motorcyclists Assn Inc	/org/christian-motorcyclists-assn-inc
Love Never Fails Ministries	/org/love-never-fails-ministries
South Central Section Of The Ninety-Nines Inc	/org/south-central-section-of-the-ninety-nines-inc-18
United Studies Inc	/org/united-studies-inc
Fulton County Council On Aging Inc	/org/fulton-county-council-on-aging-inc
Arkansas Community Institute	/org/arkansas-community-institute
Lisemby Family Evangelistic Ministries Inc	/org/lisemby-family-evangelistic-ministries-inc
Gurdjieff Foundation Of Arkansas	/org/gurdjieff-foundation-of-arkansas
General Council Of The Assemblies Of God	/org/general-council-of-the-assemblies-of-god-203
Arkansas 4-H Foundation Inc	/org/arkansas-4-h-foundation-inc
United Daughters Of The Confederacy	/org/united-daughters-of-the-confederacy-73
United Daughters Of The Confederacy	/org/united-daughters-of-the-confederacy-74
Universal Christian Fellowship Inc	/org/universal-christian-fellowship-inc
Hilltop Community Bible Rock Church	/org/hilltop-community-bible-rock-church
First Christian Church & Waterway	/org/first-christian-church-waterway
Future Farmers Of America State Associations & Local Chapter	/org/future-farmers-of-america-state-associations-local-chapter-333
John Ed Chambers Memorial Hospital	/org/john-ed-chambers-memorial-hospital
Mississippi County Union	/org/mississippi-county-union
H M Wilson Trust For The Associated Reform Presbyterian Church Term	/org/h-m-wilson-trust-for-the-associated-reform-presbyterian-church-term
Arkansas Society Of Certified Public Accountants Student Loan Fu	/org/arkansas-society-of-certified-public-accountants-student-loan-fu
Junior League Of Fort Smith Inc	/org/junior-league-of-fort-smith-inc
Little Rock Garden Club	/org/little-rock-garden-club
National Society Of The Daughters Of The American Revolution	/org/national-society-of-the-daughters-of-the-american-revolution-273
National Society Of The Daughters Of The American Revolution	/org/national-society-of-the-daughters-of-the-american-revolution-274
United Daughters Of The Confederacy	/org/united-daughters-of-the-confederacy-75
Toastmasters International	/org/toastmasters-international-7971
Boy Scouts Of America Trust Fund	/org/boy-scouts-of-america-trust-fund-21
Centro Cristiano Hispano	/org/centro-cristiano-hispano-6
Church On The Rock-Polk County	/org/church-on-the-rock-polk-county
Genesis Community Development Center Inc	/org/genesis-community-development-center-inc
Conway Regional Health Foundation Inc	/org/conway-regional-health-foundation-inc
His Touch Ministries International	/org/his-touch-ministries-international
Faith Assembly Of God	/org/faith-assembly-of-god-82
Friends For Life Inc	/org/friends-for-life-inc
Mars Hill Volunteer Fire Department	/org/mars-hill-volunteer-fire-department
Lakewood Child Care Center Inc	/org/lakewood-child-care-center-inc
St. Francis County Family Resources, Inc.	/org/st-francis-county-family-resources-inc
Saline County Art League	/org/saline-county-art-league
Happy Days Day Care & Learning Center, Inc.	/org/happy-days-day-care-learning-center-inc
Delta Transitional Home	/org/delta-transitional-home
North Arkansas Medical System	/org/north-arkansas-medical-system
Arkansas Canine Tails	/org/arkansas-canine-tails
Southeast Arkansas School Of Janitorial & Yard Maintenance Svc	/org/southeast-arkansas-school-of-janitorial-yard-maintenance-svc
Kuc, Inc.	/org/kuc-inc
Ouachita County Medical Services	/org/ouachita-county-medical-services
Hot Spring County Medical Services	/org/hot-spring-county-medical-services
Arkansas Music Educators Association	/org/arkansas-music-educators-association
Arkansas Independent Living Council	/org/arkansas-independent-living-council
Boys & Girls Club Of Ashley County Inc	/org/boys-girls-club-of-ashley-county-inc
Moody Elementary School Pto	/org/moody-elementary-school-pto
Pea Ridge Babe Ruth Inc	/org/pea-ridge-babe-ruth-inc
Maturing Word Ministries	/org/maturing-word-ministries
Kid Kare Of Batesville, Inc.	/org/kid-kare-of-batesville-inc
National Society United States Daughters Of 1812	/org/national-society-united-states-daughters-of-1812-168
Childrens Town Preschool Inc	/org/childrens-town-preschool-inc
Immanuels Rescue Mission Bountiful Harvest	/org/immanuels-rescue-mission-bountiful-harvest
Arkansas Country Doctor Museum	/org/arkansas-country-doctor-museum
North Arkansas Youth Center	/org/north-arkansas-youth-center
Happy Land Child Care Center Inc	/org/happy-land-child-care-center-inc
Mercy Hospital Berryville	/org/mercy-hospital-berryville
Trinity Heights Academy	/org/trinity-heights-academy
Echlins Child Care Center Inc	/org/echlins-child-care-center-inc
Arkansas Childrens Hospital Research Institute	/org/arkansas-childrens-hospital-research-institute
Sfc Cultural Foundation Inc	/org/sfc-cultural-foundation-inc
Pta Arkansas Congress	/org/pta-arkansas-congress_72263
Independence County Economic Development Foundations Inc	/org/independence-county-economic-development-foundations-inc
Word Foundations Ministries	/org/word-foundations-ministries
Marion Youth Sports Association Inc	/org/marion-youth-sports-association-inc
Howard Health System	/org/howard-health-system
Cottonwood Rural Fire Association	/org/cottonwood-rural-fire-association
Arkansas Quality Council Inc	/org/arkansas-quality-council-inc
Literacy Council Of St Francis County	/org/literacy-council-of-st-francis-county
The Springdale Rotary Charitable Foundation Trust	/org/the-springdale-rotary-charitable-foundation-trust
Christmas Brings Hope Inc 500 East Main	/org/christmas-brings-hope-inc-500-east-main
Miracle Lighthouse Church	/org/miracle-lighthouse-church
Calvary Assembly Of God	/org/calvary-assembly-of-god-84
Northwest Arkansas Crisis Intervention Center	/org/northwest-arkansas-crisis-intervention-center
Riggs Employees Fund	/org/riggs-employees-fund
Arkansas Health Affiliates Inc	/org/arkansas-health-affiliates-inc
Russellville Band Boosters Club Inc	/org/russellville-band-boosters-club-inc
Dequeen Mena Educational Cooperative	/org/dequeen-mena-educational-cooperative
Junior Auxiliary Of Harrison Arkansas Incorporated	/org/junior-auxiliary-of-harrison-arkansas-incorporated
Lonsdale Fire Association Incorporated	/org/lonsdale-fire-association-incorporated
Pta Arkansas Congress	/org/pta-arkansas-congress_72290
Pta Arkansas Congress	/org/pta-arkansas-congress_72291
Northeast Arkansas Humane Association	/org/northeast-arkansas-humane-association
New Day Ministries Inc	/org/new-day-ministries-inc
Apostolic Faith Temple Church Of Jesus Christ	/org/apostolic-faith-temple-church-of-jesus-christ
Community Service Properties Inc	/org/community-service-properties-inc
Agape Fellowship Church Caulksville Arkansas	/org/agape-fellowship-church-caulksville-arkansas
Watershed Human And Community Development Agency Inc	/org/watershed-human-and-community-development-agency-inc
Gould Community Service Corporation Gcsc	/org/gould-community-service-corporation-gcsc
Womens Crisis Center	/org/womens-crisis-center
Pta Arkansas Congress	/org/pta-arkansas-congress_72305
The Fairfield Bay Community Foundation	/org/the-fairfield-bay-community-foundation
Carti Foundation Inc	/org/carti-foundation-inc
