org_name	org_url
Shakespeare & Company, Inc.	/org/shakespeare-company-inc
GREY2K USA Worldwide	/org/grey2k-usa-worldwide
Cradles to Crayons	/org/cradles-to-crayons
International Fund for Animal Welfare, Inc.	/org/international-fund-for-animal-welfare-inc
Hands Across the Sea, Inc.	/org/hands-across-the-sea-inc-1
Friends of the Arava Institute	/org/friends-of-the-arava-institute
Camp Starfish Inc	/org/camp-starfish-inc
All Hands Volunteers	/org/all-hands-volunteers
Keshet Inc	/org/keshet-inc
GREY2K USA Education Fund	/org/grey2k-usa-education-fund
Blue Star Equiculture Incorporated	/org/blue-star-equiculture-incorporated
VHL Alliance	/org/vhl-alliance
Free Press	/org/free-press
The Next Step Fund, Inc.	/org/the-next-step-fund-inc
Ceres	/org/ceres
Binkeez for Comfort	/org/binkeez-for-comfort
HandReach	/org/handreach
Rose Kennedy Greenway Conservancy	/org/rose-kennedy-greenway-conservancy
Seeds of Solidarity Education Center Inc	/org/seeds-of-solidarity-education-center-inc
Jeffs Place Childrens Bereavement Center Inc	/org/jeffs-place-childrens-bereavement-center-inc
Joy of Music Program, Inc.	/org/joy-of-music-program-inc
Cowan Slavin Foundation Corp	/org/cowan-slavin-foundation-corp
Perkins School for the Blind	/org/perkins-school-for-the-blind
Elizabeth Stone House, Inc.	/org/elizabeth-stone-house-inc
People Making a Difference (PMD)	/org/people-making-a-difference-pmd
Berkshire Environmental Action Team	/org/berkshire-environmental-action-team
FRAXA Research Foundation	/org/fraxa-research-foundation
Ellen M Gifford Sheltering Home Corporation	/org/ellen-m-gifford-sheltering-home-corporation
Science Club for Girls	/org/science-club-for-girls
New England Equine Rescue - North, Inc	/org/new-england-equine-rescue-north-inc
American Bladder Cancer Society Inc	/org/american-bladder-cancer-society-inc
Technology For Autism Now, Inc	/org/technology-for-autism-now-inc
The Steppingstone Foundation	/org/the-steppingstone-foundation
Facioscapulohumeral Society	/org/facioscapulohumeral-society
Mayyim Hayyim Living Waters Community Mikveh and Education	/org/mayyim-hayyim-living-waters-community-mikveh-and-education
The Walden Woods Project	/org/the-walden-woods-project
The Samfund	/org/the-samfund
Mil Milagros Inc	/org/mil-milagros-inc
Newton San Juan Del Sur Sister City Project Inc	/org/newton-san-juan-del-sur-sister-city-project-inc
Connect Africa Foundation Inc	/org/connect-africa-foundation-inc
Dream Big!	/org/dream-big-1
Cancer Education and Research Institute (formerly Cancer Research Simplified)	/org/cancer-education-and-research-institute-formerly-cancer-research-simplified
Ehrick Garions Act	/org/ehrick-garions-act
SustainUS, Inc.	/org/sustainus-inc
Effortz Foundation Inc	/org/effortz-foundation-inc
National Priorities Project	/org/national-priorities-project
Home Away Boston Inc.	/org/home-away-boston-inc
NeedyMeds	/org/needymeds
Jewish Women's Archive	/org/jewish-womens-archive
Tanzania School Foundation	/org/tanzania-school-foundation
The Decibels Foundation	/org/the-decibels-foundation
Pathfinder International	/org/pathfinder-international
Community Access to the Arts, Inc.	/org/community-access-to-the-arts-inc
Christopher's Haven	/org/christophers-haven
Option Institute and Fellowship	/org/option-institute-and-fellowship
Springfield Rescue Mission, Inc.	/org/springfield-rescue-mission-inc
Women's Educational Center	/org/womens-educational-center
Boston Partners in Education	/org/boston-partners-in-education
American Institute For Economic Research Inc	/org/american-institute-for-economic-research-inc
PetChance.org	/org/petchance-org
African Community Education Program	/org/african-community-education-program
World Animal Net	/org/world-animal-net
Minutes for Memories Foundation	/org/minutes-for-memories-foundation
Haiti Projects Inc	/org/haiti-projects-inc
Animal Shelter Inc	/org/animal-shelter-inc-1
Homes for Our Troops, Inc.	/org/homes-for-our-troops-inc
Baypath Humane Society Of Hopkinton Inc	/org/baypath-humane-society-of-hopkinton-inc
Caribbean Education Foundation - CEF	/org/caribbean-education-foundation-cef
Ocean River Institute Inc	/org/ocean-river-institute-inc
Pratthanadee Foundation	/org/pratthanadee-foundation
Multi-Arts, Inc.	/org/multi-arts-inc
United for a Fair Economy, Inc.	/org/united-for-a-fair-economy-inc
Extras for Creative Reuse Inc.	/org/extras-for-creative-reuse-inc
Immigrant Learning Center Inc	/org/immigrant-learning-center-inc
Limitless Horizons Ixil, Inc.	/org/limitless-horizons-ixil-inc
The Ellie Fund	/org/the-ellie-fund
FNE International	/org/fne-international
Conservation Through Poverty Alleviation International Inc	/org/conservation-through-poverty-alleviation-international-inc
Cape Abilities Inc	/org/cape-abilities-inc
Veterans Inc.	/org/veterans-inc
Pavoh Inc.	/org/pavoh-inc
Second Chance Animal Shelter Inc	/org/second-chance-animal-shelter-inc
National Yiddish Book Center	/org/national-yiddish-book-center
Lowell Parks and Conservation Trust, Inc.	/org/lowell-parks-and-conservation-trust-inc
Saheli, Support and Friendship for South Asian Women and Families	/org/saheli-support-and-friendship-for-south-asian-women-and-families
Vested Interest in K9s Inc	/org/vested-interest-in-k9s-inc
EcoLogic Development Fund	/org/ecologic-development-fund
New England Wild Flower Society	/org/new-england-wild-flower-society
Join for Justice	/org/join-for-justice
Jhamtse International	/org/jhamtse-international
Soccer Without Borders	/org/soccer-without-borders
Nurturing Minds Inc	/org/nurturing-minds-inc
Soar 55	/org/soar-55
Barka Foundation Inc	/org/barka-foundation-inc
One Village at a Time	/org/one-village-at-a-time
WomenExplore Lecture and Discussion Forum	/org/womenexplore-lecture-and-discussion-forum
Metropolitan Wind Symphony Inc	/org/metropolitan-wind-symphony-inc
Creative Action Institute	/org/creative-action-institute
Catch The Science Bug Foundation, Inc.	/org/catch-the-science-bug-foundation-inc
Globalcures Inc	/org/globalcures-inc
Fight for the Future	/org/fight-for-the-future
Transcultural Exchange Inc	/org/transcultural-exchange-inc
Community Servings	/org/community-servings
Circle of Women	/org/circle-of-women
VSA arts of Massachusetts, Inc.	/org/vsa-arts-of-massachusetts-inc
Communities Without Borders	/org/communities-without-borders-1
Service Dog Project Inc	/org/service-dog-project-inc
Casa Myrna	/org/casa-myrna
North Shore Elder Services, Inc.	/org/north-shore-elder-services-inc
Bottom Line Inc	/org/bottom-line-inc
Beverly Bootstraps	/org/beverly-bootstraps
Walpole Footlighters Inc	/org/walpole-footlighters-inc
Advocates For Home Education in Massachusetts Inc	/org/advocates-for-home-education-in-massachusetts-inc
City Mission Society of Boston Inc	/org/city-mission-society-of-boston-inc
The Dance Complex	/org/the-dance-complex
Provincetown Counter Productions	/org/provincetown-counter-productions
Hands to Heart Center - Yoga for the People	/org/hands-to-heart-center-yoga-for-the-people
The MINDS Foundation	/org/the-minds-foundation
Flying Kites	/org/flying-kites
Reading Owls International	/org/reading-owls-international
Dress for Success Boston	/org/dress-for-success-boston
Brookline Community Mental Health Center Inc	/org/brookline-community-mental-health-center-inc
Interfaithfamily Com Inc	/org/interfaithfamily-com-inc
Junior Achievement of Western Massachusetts, Inc.	/org/junior-achievement-of-western-massachusetts-inc
Massachusetts Lions Eye Research Fund Inc	/org/massachusetts-lions-eye-research-fund-inc
International Bridges To Justice	/org/international-bridges-to-justice
15-40 Connection, inc.	/org/15-40-connection-inc
Bread of Life	/org/bread-of-life-2
Panafrican Acupuncture Project Inc	/org/panafrican-acupuncture-project-inc
New Sector Alliance	/org/new-sector-alliance
May Institute	/org/may-institute
Meeting Street Massachusetts Inc	/org/meeting-street-massachusetts-inc
Jessica Locke Firefighters Fund Inc	/org/jessica-locke-firefighters-fund-inc
Friends of the William E Carter School Inc	/org/friends-of-the-william-e-carter-school-inc
Ipswich River Watershed Association Inc	/org/ipswich-river-watershed-association-inc
Generations Incorporated	/org/generations-incorporated-1
Planet Aid, Inc.	/org/planet-aid-inc
My Brother's Table, Inc.	/org/my-brothers-table-inc
Technology Exchange Lab Inc.	/org/technology-exchange-lab-inc
Youth Action Coalition Inc	/org/youth-action-coalition
John Andrew Mazie Memorial Foundation	/org/john-andrew-mazie-memorial-foundation
Westfield Homeless Cat Project	/org/westfield-homeless-cat-project
Forever Home Rescue New England	/org/forever-home-rescue-new-england
The Albert Schweitzer Fellowship	/org/the-albert-schweitzer-fellowship
Massachusetts Business Alliance for Education Inc	/org/massachusetts-business-alliance-for-education-inc
Kevs Foundation	/org/kevs-foundation
DAKTARI Bush School & Wildlife Orphanage	/org/daktari-bush-school-wildlife-orphanage
National Alliance on Mental Illness of Massachusetts	/org/national-alliance-on-mental-illness-of-massachusetts
Cultural Care Kids First Foundation	/org/cultural-care-kids-first-foundation
The Open Door/Cape Ann Food Pantry, Inc.	/org/the-open-door-cape-ann-food-pantry-inc
Four Paws International Inc.	/org/four-paws-international-inc
M.O.E.R Foundation, Inc.	/org/m-o-e-r-foundation-inc
The Papillon Foundation	/org/the-papillon-foundation
Operation Help Now, Inc.	/org/operation-help-now-inc-4
New England Innocence Project	/org/new-england-innocence-project
People for Cats	/org/people-for-cats
Ste Jeanne D'Arc Haiti Foundation	/org/ste-jeanne-darc-haiti-foundation
Northeast Massachusetts Youth Orchestras Inc.	/org/northeast-massachusetts-youth-orchestras-inc
Colored Pencil Project	/org/colored-pencil-project
Kironde Education and Health Fund	/org/kironde-education-and-health-fund
EF High School Exchange Year	/org/ef-high-school-exchange-year
Animal Rescue League of Boston	/org/animal-rescue-league-of-boston
Danforth Museum Corp	/org/danforth-museum-corp
Network Health	/org/network-health
Humane Society-Lowell	/org/humane-society-lowell
River House Inc	/org/river-house-inc-1
Girls Incorporated of Worcester	/org/girls-incorporated-of-worcester
Nivasa Foundation	/org/nivasa-foundation
National Marine Life Center, Inc.	/org/national-marine-life-center-inc
Hilltop Humane Society Inc	/org/hilltop-humane-society-inc
Central New England Equine Rescue Inc	/org/central-new-england-equine-rescue-inc
Feminists Against Academic Discrimination Inc	/org/feminists-against-academic-discrimination-inc
ACTON-BOXBOROUGH FAMILY NETWORK	/org/acton-boxborough-family-network
African Development Initiative Inc	/org/african-development-initiative-inc
Usher Syndrome Coalition	/org/usher-syndrome-coalition
African and American Friendship, Inc.	/org/african-and-american-friendship-inc
Children's Well-Being Foundation	/org/childrens-well-being-foundation
Youthbuild USA, Inc.	/org/youthbuild-usa-inc-1
Piers Park Sailing Center Inc	/org/piers-park-sailing-center-inc
Maya Traditions	/org/maya-traditions
Kennedy-Donovan Center, Inc.	/org/kennedy-donovan-center-inc
Kiwanis Club of Hanson Foundation	/org/kiwanis-club-of-hanson-foundation
M M A S Inc	/org/m-m-a-s-inc
Everybody Wins! USA	/org/everybody-wins-usa
Rubinstein-Taybi Syndrome Childrens Foundation	/org/rubinstein-taybi-syndrome-childrens-foundation
Farm Education Inc	/org/farm-education-inc
Aids Project Worcester Inc	/org/aids-project-worcester-inc
Hope Through Health, Inc.	/org/hope-through-health-inc
DC Empowering Children, Inc.	/org/dc-empowering-children-inc
Land Conservation and Advocacy Trust, Inc.	/org/land-conservation-and-advocacy-trust-inc
Society for Participatory Medicine	/org/society-for-participatory-medicine
The National Center on Family Homelessness	/org/the-national-center-on-family-homelessness
North Country Sustainability Center, Inc.	/org/north-country-sustainability-center-inc
Enter Stage Left Theater, Inc.	/org/enter-stage-left-theater-inc
Welcome Project Inc	/org/welcome-project-inc
The Wish Project, Inc.	/org/the-wish-project-inc
Interfaith Social Services, Inc	/org/interfaith-social-services-inc
Shelter Music Boston	/org/shelter-music-boston
Cappella Clausura Inc	/org/cappella-clausura-inc
Furniture Trust Organization Inc	/org/furniture-trust-organization-inc
Second Step, Inc.	/org/second-step-inc
givetwig, Inc.	/org/givetwig-inc
YMCA Greater Boston	/org/ymca-greater-boston
Centerboard Inc	/org/centerboard-inc
Project Prakash Foundation	/org/project-prakash-foundation
Children Across America	/org/children-across-america
Carrie A. Seaman Animal Shelter, Inc.	/org/carrie-a-seaman-animal-shelter-inc
PAZ Pan American Zoonotic Research and Prevention	/org/paz-pan-american-zoonotic-research-and-prevention
Boys & Girls Club Of Fitchburg and Leominster	/org/boys-girls-club-of-fitchburg-and-leominster
Jeffrey Coombs Memorial Foundation Inc	/org/jeffrey-coombs-memorial-foundation-inc
Bolton Conservation Trust Inc	/org/bolton-conservation-trust-inc
Project New Hope Inc.	/org/project-new-hope-inc-1
Partners in Health a Nonprofit Corporation	/org/partners-in-health-a-nonprofit-corporation
Harmony Fund Inc	/org/harmony-fund-inc-1
Young Heroes Foundation	/org/young-heroes-foundation
Natik Esperanza	/org/natik-esperanza
Olancho Aid Foundation Inc	/org/olancho-aid-foundation-inc
Friends Of Middlesex Fells Reservation Inc	/org/friends-of-middlesex-fells-reservation-inc
Old Colony Montessori School Inc	/org/old-colony-montessori-school
Life Saver Ministries Inc	/org/life-saver-ministries-inc
Oxfam America	/org/oxfam-america
Partners In Development, Inc.	/org/partners-in-development-inc-1
Mystic River Watershed Association Inc	/org/mystic-river-watershed-association-inc
Citizen Schools	/org/citizen-schools
Press Pass TV	/org/press-pass-tv
Earthwatch Expeditions, Inc.	/org/earthwatch-institute
North Shore Alliance of Gay & Lesbian Youth	/org/north-shore-alliance-of-gay-lesbian-youth
Camino Verde Inc	/org/camino-verde-inc-1
Paws 4 A Cure	/org/paws-4-a-cure
Crossover Basketball and Scholars Academy	/org/crossover-basketball-and-scholars-academy
New England All Breed Rescue	/org/new-england-all-breed-rescue
The Treehouse Foundation Inc	/org/the-treehouse-foundation-inc
Brain Aneurysm Foundation Incorporated	/org/brain-aneurysm-foundation-incorporated
Actors Studio Of Newburyport Inc	/org/actors-studio-of-newburyport-inc
Womens Lunch Place Inc	/org/womens-lunch-place-inc
The Literacy Project, Ware	/org/the-literacy-project-ware
Ministries of Aides International Inc	/org/ministries-of-aides-international-inc
Austen Riggs Center Inc	/org/austen-riggs-center-inc
Merrimack River Watershed Council Inc	/org/merrimack-river-watershed-council-inc
Massachusetts Coalition for Occupational Safety & Health, Inc.	/org/massachusetts-coalition-for-occupational-safety-amp-health-inc
Pan Massachusetts Challenge Trust	/org/pan-massachusetts-challenge-trust
Country Dance & Song Society Inc	/org/country-dance-song-society-inc-27
CLASS, Inc.	/org/class-inc
East Longmeadow Educational Endowment Fund, Inc.	/org/east-longmeadow-educational-endowment-fund-inc
Ellis Memorial and Eldredge House Inc	/org/ellis-memorial-and-eldredge-house-inc
Sight Loss Services Inc	/org/sight-loss-services-inc
National Tay Sachs & Allied Diseases Association Inc	/org/national-tay-sachs-allied-diseases-association-inc
Foster Parrots Ltd.	/org/foster-parrots-ltd
Soldier On, Inc.	/org/soldier-on-inc
Challenge Unlimited	/org/challenge-unlimited
Dana-Farber Cancer Institute	/org/dana-farber-cancer-institute
Trustees of Reservations	/org/trustees-of-reservations
Right Question Institute, Inc.	/org/right-question-institute-inc
Hartsprings Foundation Inc	/org/hartsprings-foundation-inc
Apple Tree Arts, Inc.	/org/apple-tree-arts-inc
Udavum Karangal Of Usa	/org/udavum-karangal-of-usa
David William Feeney Fund	/org/david-william-feeney-fund
Montachusett Interfaith Hospitality Network Inc	/org/montachusett-interfaith-hospitality-network-inc
The Red Sox Foundation Inc	/org/the-red-sox-foundation-inc
Akshaya Patra Foundation USA	/org/akshaya-patra-foundation-usa
Andover Village Improvement Society	/org/andover-village-improvement-society
Nuestro Ahora, Inc.	/org/nuestro-ahora-inc
Ray Of Hope Children Services	/org/ray-of-hope-children-services
Alzheimers Disease Research Foundation dba Cure Alzheimer's Fund	/org/alzheimers-disease-research-foundation-dba-cure-alzheimers-fund
Here-In-Our Motives Evolve Inc	/org/here-in-our-motives-evolve-inc
Massachusetts Immigrant and Refugee Advocacy Coalition	/org/massachusetts-immigrant-and-refugee-advocacy-coalition
Needham Community Council Inc	/org/needham-community-council-inc
The Jenney Grist Mill, Inc.	/org/the-jenney-grist-mill-inc
Mission of Deeds Inc	/org/mission-of-deeds-inc
Neuroendocrine Tumor Research Foundation, Inc	/org/neuroendocrine-tumor-research-foundation-inc
Franklin County Community	/org/franklin-county-community
World Education, Inc.	/org/world-education-inc
National Library Of Addictions, Inc.	/org/national-library-of-addictions-inc
Union of Concerned Scientists, Inc.	/org/union-of-concerned-scientists-inc
Pathways to Wellness Inc.	/org/pathways-to-wellness-inc
Suitability Inc	/org/suitability-inc
National Association Of Youth-Owned Businesses	/org/national-association-of-youth-owned-businesses
Victim Rights Law Center Inc	/org/victim-rights-law-center-inc
Provincetown Art Association and Museum Inc	/org/provincetown-art-association-and-museum-inc
Jumpstart for Young Children, Inc.	/org/jumpstart-for-young-children-inc
Urban Wildlife Rehabilitation Inc	/org/urban-wildlife-rehabilitation-inc
Antique Auto Museum Of Mass At Larz Anderson Park Inc	/org/antique-auto-museum-of-mass-at-larz-anderson-park-inc
Wake Up Narcolepsy Inc	/org/wake-up-narcolepsy-inc
National Education For Assistance Dog Services Inc	/org/national-education-for-assistance-dog-services-inc
Historic Highfield Inc	/org/historic-highfield-inc
Mount Grace Land Conservation Trust Inc	/org/mount-grace-land-conservation-trust-inc
Berkshire Community Action Council Inc	/org/berkshire-community-action-council-inc
Northeast Independent Living Program Inc	/org/northeast-independent-living-program-inc
Cerebral Palsy Of Massachusetts Inc	/org/cerebral-palsy-of-massachusetts-inc
Groundwork Somerville Inc	/org/groundwork-somerville-inc
Massachusetts Society For The Prevention Of Cruelty To Animals	/org/massachusetts-society-for-the-prevention-of-cruelty-to-animals
Sibling Connections, Inc.	/org/sibling-connections-inc
Summer Beit Midrash Inc	/org/summer-beit-midrash-inc
Toy Poodle Rescue	/org/toy-poodle-rescue
Cambridge Credit Counseling Corp	/org/cambridge-credit-counseling-corp
Aruna Partnership Inc	/org/aruna-partnership-inc
Cambridge School Volunteers, Inc.	/org/cambridge-school-volunteers-inc
L'Arche Irenicon	/org/larche-irenicon
World Computer Exchange Inc	/org/world-computer-exchange-inc
Matchingdonors Com Inc	/org/matchingdonors-com-inc
Precious Project Inc	/org/precious-project-inc
Beauty Without Borders Inc	/org/beauty-without-borders-inc
Northern Skies Childrens Camp	/org/northern-skies-childrens-camp
Pakachoag Music School of Greater Worcester	/org/pakachoag-music-school-of-greater-worcester
Boston City Singers Inc	/org/boston-city-singers-inc
Monkeyhouse Inc	/org/monkeyhouse-inc
The Greater Boston Food Bank, Inc.	/org/the-greater-boston-food-bank-inc
New Beginnings Singles Support Group-Norwell	/org/new-beginnings-singles-support-group-norwell
SOCIEDAD LATINA INC	/org/sociedad-latina-inc
ASTRONOMICAL SOCIETY OF SOUTHERN NEW ENGLAND INC	/org/astronomical-society-of-southern-new-england-inc
ST PAULS SOUP KITCHEN INC	/org/st-pauls-soup-kitchen-inc
CREATIVE LIVING INC	/org/creative-living-inc
Chinese Culture Connection Inc	/org/chinese-culture-connection-inc
JVS Boston	/org/jvs-boston
Paw Safe Animal Rescue, Inc.	/org/paw-safe-animal-rescue-inc
Leap Self-Defense Inc	/org/leap-self-defense-inc
United Planet	/org/united-planet
Worcester Chamber Music Society Inc	/org/worcester-chamber-music-society-inc
Notre Dame Cristo Rey High School	/org/notre-dame-cristo-rey-high-school
CRY - Child Rights and You America Inc.	/org/cry-child-rights-and-you-america-inc
National Cfids Foundation Inc	/org/national-cfids-foundation-inc
Medical Missions For Children, Inc. aka MMFC	/org/medical-missions-for-children-inc-aka-mmfc
Doug Flutie Jr Foundation For Autism Inc	/org/doug-flutie-jr-foundation-for-autism-inc
Special Olympics Massachusetts Inc	/org/special-olympics-massachusetts-inc
Fruitlands Museums Inc	/org/fruitlands-museums-inc
AMERICAN CANCER SOCIETY INC	/org/american-cancer-society-inc-2
Lionheart Foundation	/org/lionheart-foundation
Cultural Survival, Inc.	/org/cultural-survival-inc
Reliant Medical Group Foundation	/org/reliant-medical-group-foundation
New Generation Energy	/org/new-generation-energy
First Night Worcester Inc	/org/first-night-worcester-inc
Arthroplasty Patient Foundation Inc	/org/arthroplasty-patient-foundation-inc
Tenacity Inc	/org/tenacity-inc
Wicked Good Cause Organization Inc	/org/wicked-good-cause-organization-inc
Bridge Over Troubled Waters Inc	/org/bridge-over-troubled-waters-inc-1
Biodiversity for a Livable Climate	/org/biodiversity-for-a-livable-climate
Empower 2 Play	/org/empower-2-play
The Elizabeth Stone House Transitional Housing Project Inc	/org/the-elizabeth-stone-house-transitional-housing-project-inc
Medicine Mammals	/org/medicine-mammals
Artsbridge Inc Making A Differencethrough Art	/org/artsbridge-inc-making-a-differencethrough-art
National Breast Cancer Prevention Project	/org/national-breast-cancer-prevention-project
North Shore Health Project Inc	/org/north-shore-health-project-inc
National Association Of Asian Professionals-Boston Inc	/org/national-association-of-asian-professionals-boston-inc
Helping Communities in Crisis, Inc.	/org/helping-communities-in-crisis-inc
International Physicians For The Prevention Of Nuclear War	/org/international-physicians-for-the-prevention-of-nuclear-war
House Rabbit Network Inc	/org/house-rabbit-network-inc
Help From Above Services Inc	/org/help-from-above-services-inc
Community Boating Inc	/org/community-boating-inc
Journey Forward Inc	/org/journey-forward-inc
Auburn Vna Health Network Inc	/org/auburn-vna-health-network-inc
The Riverway Project	/org/the-riverway-project
On The Rise Inc	/org/on-the-rise-inc
AMERICAN FRIENDS OF GEORGIA INC	/org/american-friends-of-georgia-inc
Orion Society	/org/orion-society
Boys & Girls Club Of Lynn	/org/boys-girls-club-of-lynn
HOPE FOR LIMPOPO INC	/org/hope-for-limpopo-inc
Sadd Inc	/org/sadd-inc
Boston Harbor Association Inc	/org/boston-harbor-association-inc
Childrens Dyslexia Centers Inc	/org/childrens-dyslexia-centers-inc
Lutheran Social Services of New England, Inc.	/org/lutheran-social-services-of-new-england-inc-1
Wellbody Alliance	/org/wellbody-alliance
The Foresight Project Inc.	/org/the-foresight-project-inc
Harvard Museum of Natural History	/org/harvard-museum-of-natural-history
phoenixgroup, Inc.	/org/phoenixgroup-inc
THE BOSTON FOUNDATION FOR SIGHT	/org/the-boston-foundation-for-sight
Sarasa Inc	/org/sarasa-inc
Bosler Humane Society Inc	/org/bosler-humane-society-inc
COMMUNITY ACTION, INC	/org/community-action-inc-1
Northeastern Boxer Rescue Inc	/org/northeastern-boxer-rescue-inc
LITTLETON SCHOLARSHIP TRUST	/org/littleton-scholarship-trust
New England Anti-Vivisection Society (NEAVS)	/org/new-england-anti-vivisection-society-neavs
Facing History and Ourselves, Inc.	/org/facing-history-and-ourselves-inc
St Marys Center For Women And Children	/org/st-marys-center-for-women-and-children
Growth Through Learning, Inc.	/org/growth-through-learning-inc
Andona Society	/org/andona-society
LATINO STEM ALLIANCE	/org/latino-stem-alliance
United Way Of Massachusetts Bay Inc	/org/united-way-of-massachusetts-bay-inc
Center For Labor Education And Research Inc	/org/center-for-labor-education-and-research-inc
Childrens Hospital Corporation	/org/childrens-hospital-corporation
CLOSE TO HOME DOMESTIC VIOLENCE PREVENTION INITIATIVE INC	/org/close-to-home-domestic-violence-prevention-initiative-inc
Orthodox Christian Fellowship	/org/orthodox-christian-fellowship
Transition House Inc	/org/transition-house-inc
Provide, Inc.	/org/provide-inc
Tapestry Health Systems Inc	/org/tapestry-health-systems-inc
Heading Home Inc	/org/heading-home-inc
Pioneer Valley Habitat for Humanity	/org/pioneer-valley-habitat-for-humanity
Walkboston Inc	/org/walkboston-inc
Community Resources For Justice Inc	/org/community-resources-for-justice-inc
Servants Of Christ Ministries	/org/servants-of-christ-ministries
Attleboro Land Trust Inc	/org/attleboro-land-trust-inc
Horizons For Homeless Children Inc	/org/horizons-for-homeless-children-inc
Garden Futures, Inc.	/org/garden-futures-inc
Combined Jewish Philanthropies of Greater Boston, Inc.	/org/combined-jewish-philanthropies-of-greater-boston-inc
Grassroots International	/org/grassroots-international
Spina Bifida Association of Massachusetts Inc.	/org/spina-bifida-association-of-massachusetts-inc
Nick Perry Memorial Foundation	/org/nick-perry-memorial-foundation
Care Dimensions Inc	/org/care-dimensions-inc-1
Charles River Watershed Association, Inc.	/org/charles-river-watershed-association-inc
FAMILY SERVICE ASSOCIATION OF GREATER BOSTON	/org/family-service-association-of-greater-boston
Accion International	/org/accion-international
Northeast Animal Shelter Inc	/org/northeast-animal-shelter-inc
Boston Rescue Mission, Inc.	/org/boston-rescue-mission-inc
READER TO READER INC	/org/reader-to-reader-inc
FOURAH BAY COMMUNITY FOUNDATION INC	/org/fourah-bay-community-foundation-inc
Buddy Dog Humane Society Inc	/org/buddy-dog-humane-society-inc
Wide Horizons for Children, Inc.	/org/wide-horizons-for-children-inc
Safe Havens Interfaith Partnership Against Domestic Violence	/org/safe-havens-interfaith-partnership-against-domestic-violence
Career Collaborative, Inc.	/org/career-collaborative-inc
Beyond Stage 4	/org/beyond-stage-4
Why Me, Inc.	/org/why-me-inc
Institute for International Cooperation and Development, Inc.	/org/institute-for-international-cooperation-and-development-inc
Christian Spirit Inc	/org/christian-spirit-inc
RememberUs.org	/org/rememberus-org
Friends Of Maiti Nepal A Non-Profit Corporation	/org/friends-of-maiti-nepal-a-non-profit-corporation
Hcv Support Inc	/org/hcv-support-inc
MARY ANN MORSE HEALTHCARE CORP	/org/mary-ann-morse-healthcare-corp
HULL PERFORMING ARTS INC	/org/hull-performing-arts-inc
ANIKE FOUNDATION INCORPORATED	/org/anike-foundation-incorporated
Tufts Medical Center Parent Inc	/org/tufts-medical-center-parent-inc-5
GROUNDWORK LAWRENCE INC	/org/groundwork-lawrence-inc
CHILDRENS MUSEUM	/org/childrens-museum
LUCYS LOVE BUS CHARITABLE TRUST	/org/lucys-love-bus-charitable-trust
Community Legal Services And Counseling Center Inc	/org/community-legal-services-and-counseling-center-inc
Law Enforcement Against Prohibition Educational Fund Inc	/org/law-enforcement-against-prohibition-educational-fund-inc
Hancock Shaker Village Inc	/org/hancock-shaker-village-inc
Inspire Arts And Music Inc	/org/inspire-arts-and-music-inc
Asian University For Women -Auw- Support Foundation	/org/asian-university-for-women-auw-support-foundation
GARDEN CLUB OF THE BACK BAY INC	/org/garden-club-of-the-back-bay-inc
Hearthstone Alzheimers Foundation Inc	/org/hearthstone-alzheimers-foundation-inc
Sicilian Association Of Greater Boston Inc	/org/sicilian-association-of-greater-boston-inc
Newburyport Preservation Trust Inc	/org/newburyport-preservation-trust-inc
Trustees Of Tufts College	/org/trustees-of-tufts-college
MASSACHUSETTS HORTICULTURAL SOCIETY	/org/massachusetts-horticultural-society
Massachusetts Audubon Society Inc	/org/massachusetts-audubon-society-inc
Council On Aging Associates Inc	/org/council-on-aging-associates-inc
Making A Difference In Peabody Foundation Inc	/org/making-a-difference-in-peabody-foundation-inc
Newton Community Service Centers, Inc.	/org/newton-community-service-centers-inc
KESTREL EDUCATIONAL ADVENTURES	/org/kestrel-educational-adventures
REEL RECOVERY INC	/org/reel-recovery-inc
South Shore Natural Science Center Inc	/org/south-shore-natural-science-center-inc
Center For Ecotechnology Inc	/org/center-for-ecotechnology-inc
Samaritans, Inc.	/org/samaritans-inc
Unitarian Universalist Service Committee, Inc.	/org/unitarian-universalist-service-committee-inc
Dignity Matters, Inc.	/org/dignity-matters-inc
Bostons Childrens Chorus Inc	/org/bostons-childrens-chorus-inc
Sitters Without Borders	/org/sitters-without-borders
Health To Know	/org/health-to-know
Webster Lake Association Inc	/org/webster-lake-association-inc
Ahimsa Foundation	/org/ahimsa-foundation
COALITION FOR BUZZARDS BAY INC	/org/coalition-for-buzzards-bay-inc
TARRAFAL DJUNTA MO Inc	/org/tarrafal-djunta-mo-inc
Ascentria Care Alliance Inc	/org/ascentria-care-alliance-inc
Greyhound Friends Inc	/org/greyhound-friends-inc
Massachusetts Service Alliance Inc	/org/massachusetts-service-alliance-inc
Berkshire Humane Society Inc	/org/berkshire-humane-society-inc
Thompson Island Outward Bound Education Center Inc	/org/thompson-island-outward-bound-education-center-inc
BAGONG KULTURANG PINOY INC	/org/bagong-kulturang-pinoy-inc
Boston Academy Of The Sacred Heart Inc	/org/boston-academy-of-the-sacred-heart-inc
Friends Of Payir Inc	/org/friends-of-payir-inc
World Youth Mission Inc	/org/world-youth-mission-inc
Montague Catholic Social Ministries Inc	/org/montague-catholic-social-ministries-inc
NAMI NATIONAL ALLIANCE FOR THE MENTALLY ILL PLYMOUTH AREA	/org/nami-national-alliance-for-the-mentally-ill-plymouth-area
Railroad Street Youth Project	/org/railroad-street-youth-project
I Want To Play Inc	/org/i-want-to-play-inc
Pug Rescue Of New England Inc	/org/pug-rescue-of-new-england-inc
Holyoke Rows Inc	/org/holyoke-rows-inc
Hopkinton Center For The Arts	/org/hopkinton-center-for-the-arts
Catastrophic Emergency Fund Inc	/org/catastrophic-emergency-fund-inc
A L S Family Charitable Foundation Inc	/org/a-l-s-family-charitable-foundation-inc
Legacy Of Hope Foundation	/org/legacy-of-hope-foundation
James And Beatrice Salah Family Foundation For The Town Of Canton	/org/james-and-beatrice-salah-family-foundation-for-the-town-of-canton
The Giving Circle	/org/the-giving-circle
Score For A Cure	/org/score-for-a-cure
YEAR UP INC	/org/year-up-inc
Holy Annunciation Russian Orthodox Church	/org/holy-annunciation-russian-orthodox-church
Blueskies Wellness Inc	/org/blueskies-wellness-inc
Sens Foundation	/org/sens-foundation
Breakn The Chainz Of Addictions Ministries Inc	/org/breakn-the-chainz-of-addictions-ministries-inc
Dreamfar High School Marathon	/org/dreamfar-high-school-marathon
Strongwater Farm Therapeutic Equestrian Center	/org/strongwater-farm-therapeutic-equestrian-center
The Friends Of The J V Fletcher Library Inc	/org/the-friends-of-the-j-v-fletcher-library-inc
New England Outreach Program Inc	/org/new-england-outreach-program-inc
Brookline-Quezalguaque Sister City Project Inc	/org/brookline-quezalguaque-sister-city-project-inc
Give Back Time, Inc	/org/give-back-time-inc
Friends Of Sholan Farms	/org/friends-of-sholan-farms
BACKPACKS FOR NEW BEGINNINGS INC	/org/backpacks-for-new-beginnings-inc
Walpole Childrens Theatre Inc	/org/walpole-childrens-theatre-inc
Sweat For Vets	/org/sweat-for-vets
Educational Divide Reform	/org/educational-divide-reform
LYME DISEASE RESOURCE CENTER	/org/lyme-disease-resource-center
Braintree Food Pantry Inc	/org/braintree-food-pantry-inc
Save A Dog Inc	/org/save-a-dog-inc
Chopchopkids Inc	/org/chopchopkids-inc
CHANGE SIERRA LEONE	/org/change-sierra-leone
Louis D Brown Peace Institute Corporation	/org/louis-d-brown-peace-institute-corporation
Board Of Trustees Of The Congregation Bnai Israel Endowment	/org/board-of-trustees-of-the-congregation-bnai-israel-endowment
GATEWAYS: ACCESS TO JEWISH EDUCATION	/org/gateways-access-to-jewish-education
X-Cel Inc	/org/x-cel-inc
COLONIAL THEATRE ASSOCIATION INC	/org/colonial-theatre-association-inc
1-Blue Planet Foundation Ltd	/org/1-blue-planet-foundation-ltd
