org_name	org_url
Callaway County United Way Inc	/org/callaway-county-united-way-inc
Children International	/org/children-international
Foundation for Photo Art in Hospitals Inc	/org/foundation-for-photo-art-in-hospitals-inc
COMPASSION SERVICES INTERNATIONAL	/org/compassion-services-international
Convoy of Hope	/org/convoy-of-hope
Against Malaria Foundation (US)	/org/against-malaria-foundation-us
Octarium	/org/octarium
International Crisis Aid Inc	/org/international-crisis-aid-inc
Outreach International	/org/outreach-international-1
Assistance League of Kansas City	/org/assistance-league-of-kansas-city
Healthed Connect	/org/healthed-connect
The Silver Star Families of America	/org/the-silver-star-families-of-america-1
Foster Care Coalition of Greater St Louis Inc	/org/foster-care-coalition-of-greater-st-louis-inc
Circle Of Light Associates	/org/circle-of-light-associates
Burge Bird Rescue	/org/burge-bird-rescue
H.E.R.O.E.S. Care, Inc.	/org/h-e-r-o-e-s-care-inc
Prince Ministry in South Africa	/org/prince-ministry-in-south-africa
Marian Middle School	/org/marian-middle-school
Humanity For Children	/org/humanity-for-children
Endangered Wolf Center	/org/endangered-wolf-center
Help of Raymore, Inc.	/org/help-of-raymore-inc
Jacobs House Inc	/org/jacobs-house-inc
Shepherds Centers of America	/org/shepherds-centers-of-america
Justine Petersen	/org/justine-petersen
Faith Aloud	/org/faith-aloud
Tenth Life Cat Rescue	/org/tenth-life-cat-rescue
Daisys Eye Cancer Fund	/org/daisys-eye-cancer-fund
VETERANS FOR PEACE INC - National Office	/org/veterans-for-peace-inc-national-office
Operation Shower	/org/operation-shower
Green Works in Kansas City	/org/green-works-in-kansas-city
Childrens Peace Education and Community Enrichment Center	/org/childrens-peace-education-and-community-enrichment-center
Corporate America Supports You	/org/corporate-america-supports-you
Yang-Ward Foundation, Inc.	/org/yang-ward-foundation-inc
Ivanhoe Neighborhood Council	/org/ivanhoe-neighborhood-council
Variety the Children's Charity of St. Louis	/org/variety-the-childrens-charity-of-st-louis
Project Las Americas	/org/project-las-americas
Community Women Against Hardship	/org/community-women-against-hardship
Special Horses	/org/special-horses
St Louis Learning Disabilities Association Inc	/org/st-louis-learning-disabilities-association-inc
Center for Plant Conservation Inc	/org/center-for-plant-conservation-inc
Our Lady's Inn	/org/our-ladys-inn
Springfield Victory Mission Inc	/org/springfield-victory-mission-inc
Bi-State Pet Food Pantry	/org/bi-state-pet-food-pantry
Furry Kids Refuge	/org/furry-kids-refuge
Easterseals Midwest	/org/easterseals-midwest
USO of Missouri	/org/uso-of-missouri
Ready Readers	/org/ready-readers
Alder Hill Farm	/org/alder-hill-farm
Southwest Missouri Office of Aging	/org/southwest-missouri-office-of-aging
Betty And Bobby Allison Ozarks Counseling Center	/org/betty-and-bobby-allison-ozarks-counseling-center
P.O.W. Network	/org/p-o-w-network
Supporters of Children with Additional Needs Inc	/org/supporters-of-children-with-additional-needs-inc
Lazarus Ministries at Grand Avenue Temple	/org/lazarus-ministries-at-grand-avenue-temple
Back at You	/org/back-at-you
Self Help Center	/org/self-help-center
Kinship Circle	/org/kinship-circle
Shalom House	/org/shalom-house
Noahs Ark Academy	/org/noahs-ark-academy
United Way of Southeast Missouri	/org/united-way-of-southeast-missouri
Assistance League Of St Louis	/org/assistance-league-of-st-louis
OATS, Inc.	/org/oats-inc
Project Peanut Butter	/org/project-peanut-butter
Hope For Young Adults With Cancer	/org/hope-for-young-adults-with-cancer
Mid America Teen Community Emergency Response Team	/org/mid-america-teen-community-emergency-response-team
Congenital Heart Defects Families Association	/org/congenital-heart-defects-families-association
Upstream Theater	/org/upstream-theater
Sudden Infant Death Syndrome Resources Inc	/org/sudden-infant-death-syndrome-resources-inc
Lighting the Path Enterprises	/org/lighting-the-path-enterprises
Camp Fire	/org/camp-fire
Partnership International Inc	/org/partnership-international-inc
Beloved Streets Of America Inc	/org/beloved-streets-of-america-inc
International Foundation for Autoimmune Arthritis	/org/international-foundation-for-autoimmune-arthritis
Ride On St. Louis, Inc.	/org/ride-on-st-louis-inc
Lemay Housing Partnership Inc	/org/lemay-housing-partnership-inc
Heart of America Shakespeare Festival	/org/heart-of-america-shakespeare-festival
Beauty for Ashes Ministry	/org/beauty-for-ashes-ministry-1
Missouri Association of Student Councils	/org/missouri-association-of-student-councils
Bach Aria Soloists	/org/bach-aria-soloists
Global Health Innovations	/org/global-health-innovations
United International Buddha Dhamma Inc	/org/united-international-buddha-dhamma-inc
International Institute of Metropolitan St. Louis	/org/international-institute-of-metropolitan-st-louis
Douglas County Historical and Genealogical Society Inc	/org/douglas-county-historical-and-genealogical-society-inc
Pathways to Independence	/org/pathways-to-independence
DOORWAYS Interfaith AIDS Housing Services	/org/doorways-interfaith-aids-housing-services
The L.I.F.E. Foundation	/org/the-l-i-f-e-foundation
The Community Partnership	/org/the-community-partnership-1
PKD Foundation	/org/pkd-foundation
Teens of America USA	/org/teens-of-america-usa
Camp Encourage	/org/camp-encourage
Vinelanders Community Land Trust Inc	/org/vinelanders-community-land-trust-inc
Front Porch Alliance-Kansas City	/org/front-porch-alliance
Haven of the Ozarks Animal Sanctuary	/org/haven-of-the-ozarks-animal-sanctuary
HepC Alliance	/org/hepc-alliance
Dancing Rabbit, Inc.	/org/dancing-rabbit-inc
Myasthenia Gravis Association of Kansas City	/org/myasthenia-gravis-association-of-kansas-city
Scientific Arts Foundation	/org/scientific-arts-foundation
Second Wind Lung Transplant	/org/second-wind-lung-transplant
Camp Barnabas	/org/camp-barnabas
Second Harvest Community Food Bank	/org/second-harvest-community-food-bank
Peacepathways	/org/peacepathways
Community Services League	/org/community-services-league
St Louis Senior Dog Project	/org/st-louis-senior-dog-project
St Louis Language Immersion Schools Inc	/org/st-louis-language-immersion-schools-inc
Missouri Wildlife Rescue Center	/org/missouri-wildlife-rescue-center
Circle of Hope Girls Ranch and Boarding Schools	/org/circle-of-hope-girls-ranch-and-boarding-schools
Gateway to Peace Museum Inc	/org/gateway-to-peace-museum-inc
Marineparents Com Inc	/org/marineparents-com-inc
Inner City Youth Tutoring Inc	/org/inner-city-youth-tutoring-inc
Partners In Sustainable Development International	/org/partners-in-sustainable-development-international
Berean Christian Academy Inc	/org/berean-christian-academy-inc
Guadalupe Centers	/org/guadalupe-centers
Stonelion Puppet Theatre	/org/stonelion-puppet-theatre
Responder Rescue	/org/responder-rescue
International Association of Assessing Officers	/org/international-association-of-assessing-officers-2
Harvesters Community Food Network	/org/harvesters-the-community-food-network
Bollinger County Museum of Natural History	/org/bollinger-county-museum-of-natural-history
The HALO Foundation	/org/the-halo-foundation
St. Louis Health Equipment Lending Program, Inc.	/org/st-louis-health-equipment-lending-program-inc
Helping Hands Therapeutic Riding Center	/org/helping-hands-therapeutic-riding-center
Have A Heart Dog Rescue & Adoption	/org/have-a-heart-dog-rescue-adoption
National Childrens Cancer Society Inc	/org/national-childrens-cancer-society-inc
Franklin County Humane Society of Missouri	/org/franklin-county-humane-society-of-missouri
Kansas City Rescue Mission	/org/kansas-city-rescue-mission
Owl Hollow Farm	/org/owl-hollow-farm
Bread of Life Fellowship Inc	/org/bread-of-life-fellowship-inc
Equi-Librium Therapy Center	/org/equi-librium-therapy-center
Missouri Girls Town Foundation Inc	/org/missouri-girls-town-foundation-inc
Meds & Food For Kids	/org/meds-food-for-kids
Recovery Chapel	/org/recovery-chapel
LAST - Latin American Sea Turtles	/org/last-latin-american-sea-turtles
Proyecto Bienestar	/org/proyecto-bienestar
Mitrata-Nepal Foundation For Children	/org/mitrata-nepal-foundation-for-children
Communities Creating Opportunity	/org/communities-creating-opportunity
Board Of Religious Organizations	/org/board-of-religious-organizations
Mastodon Art-Science Regional Fair	/org/mastodon-art-science-regional-fair
Metro Animal Resource Services Inc	/org/metro-animal-resource-services-inc
Harp And Shamrock-The Bob Reeder Fan Club Inc	/org/harp-and-shamrock-the-bob-reeder-fan-club-inc
City Union Mission	/org/city-union-mission-inc
Columbia Art League	/org/columbia-art-league
Veterans of Foreign Wars Foundation	/org/veterans-of-foreign-wars-foundation
National Council of Jewish Women, Inc.	/org/national-council-of-jewish-women-st-louis-section-inc
Gateway Festival Orchestra Of St Louis	/org/gateway-festival-orchestra-of-st-louis
HOME WORKS! The Teacher Home Visit Program	/org/home-works-the-teacher-home-visit-program
Guardian Oak Growth by Giving Assc.	/org/guardian-oak-growth-by-giving-assc
Child Evangelism Fellowship Inc	/org/child-evangelism-fellowship-inc-60
Habitat For Humanity Kansas City ReStore	/org/habitat-for-humanity-kansas-city-restore
LIFEWATERS	/org/lifewaters
Kids Across America Foundation	/org/kids-across-america-foundation-1
Feed My People	/org/feed-my-people
JOYCE MEYER MINISTRIES INC	/org/joyce-meyer-ministries-inc
The Rainbow Network	/org/the-rainbow-network
Discipling The Nations	/org/discipling-the-nations
Alliance For Astronomy Inc	/org/alliance-for-astronomy-inc
Friends Of Characterplus	/org/friends-of-characterplus
Discovering Options	/org/discovering-options
2000 Feet Inc	/org/2000-feet-inc
Stray Rescue Of St Louis	/org/stray-rescue-of-st-louis
Columbia Second Chance	/org/columbia-second-chance
Friends Of Turpentine Creek Wildlife Refuge	/org/friends-of-turpentine-creek-wildlife-refuge
Midway USA Foundation Inc	/org/midway-usa-foundation-inc
Moun Pou Moun Haiti	/org/moun-pou-moun-haiti-1
College of the Ozarks	/org/college-of-the-ozarks
St. Louis Crisis Nursery	/org/st-louis-crisis-nursery
Doulos Ministries Inc	/org/doulos-ministries-inc
Wyman Center, Inc.	/org/wyman-center-inc
Rose Brooks Center, Inc.	/org/rose-brooks-center-inc
Down Syndrome Association of Greater St Louis	/org/down-syndrome-association-of-greater-st-louis
All New Hope Animal Rescue Llc	/org/all-new-hope-animal-rescue-llc
The Mission Continues	/org/the-mission-continues
GREEN PARK LUTHERAN SCHOOL	/org/green-park-lutheran-school
Windermere Baptist Conference Center	/org/windermere-baptist-conference-center
Special Olympics Missouri	/org/special-olympics-missouri
Sustainable Hope International	/org/sustainable-hope-international
Birthright of St. Charles Inc.	/org/birthright-of-st-charles-inc
Ben-Nor Apartments Inc	/org/ben-nor-apartments-inc
ST LOUIS PSYCHOANALYTIC INSTITUTE	/org/st-louis-psychoanalytic-institute
Moebius Syndrome Foundation	/org/moebius-syndrome-foundation
New Life Evangelistic Center Inc	/org/new-life-evangelistic-center-inc
Lydias House Inc	/org/lydias-house-inc
Wings of Hope, Inc.	/org/wings-of-hope-inc
Pet International Inc	/org/pet-international-inc
Sgsm Network Inc	/org/sgsm-network-inc
Friends Of Kids With Cancer Inc	/org/friends-of-kids-with-cancer-inc
Laclede County Pregnancy Support Center	/org/laclede-county-pregnancy-support-center
NEWHOUSE	/org/newhouse
Vision Research Foundation Of Kansas City Inc	/org/vision-research-foundation-of-kansas-city-inc
Pony Bird, Inc.	/org/pony-bird-inc
Big Bend Railroad Club, Inc.	/org/big-bend-railroad-club-inc
ARNOLD MISSOURI HISTORICAL SOCIETY	/org/arnold-missouri-historical-society
Pets A Lone Sanctuary Of Lincoln	/org/pets-a-lone-sanctuary-of-lincoln
Toastmasters International	/org/toastmasters-international_759242
THE ANIMAL SHELTER OF TEXAS COUNTY	/org/the-animal-shelter-of-texas-county
Rebuilding Together Clay County Inc	/org/rebuilding-together-clay-county-inc
AMERICAN LEGION BAND OF GREATER KANSAS CITY	/org/american-legion-band-of-greater-kansas-city
Soorya Performing Arts	/org/soorya-performing-arts
Happy Dogs Rescue	/org/happy-dogs-rescue
BILINGUAL INTERNATIONAL ASSISTANT SERVICES	/org/bilingual-international-assistant-services
SouthSide Early Childhood Center	/org/southside-early-childhood-center
Mothers Refuge	/org/mothers-refuge
Joplin Humane Society Inc	/org/joplin-humane-society-inc
Future Leaders Outreach Network	/org/future-leaders-outreach-network
Animal Protective Association Of Missouri	/org/animal-protective-association-of-missouri
Usa Athletes International Inc	/org/usa-athletes-international-inc
Ella Ragland Art	/org/ella-ragland-art
National Child Safety Foundation	/org/national-child-safety-foundation
All Paws Rescue Inc	/org/all-paws-rescue-inc-1
Flawdogs Adoption	/org/flawdogs-adoption
Society Of St Vincent De Paul Archdiocesan Council Of St Louis	/org/society-of-st-vincent-de-paul-archdiocesan-council-of-st-louis
Metropolitan Organization To Counter Sexual Assault	/org/metropolitan-organization-to-counter-sexual-assault
HOPE 4 TODAY	/org/hope-4-today
Missouri Botanical Garden	/org/missouri-botanical-garden
Hope House Inc	/org/hope-house-inc-4
Omega Psi Phi Fraternity Iota Sigma Chapter	/org/omega-psi-phi-fraternity-iota-sigma-chapter
Lupus Foundation Of America - Heartland Chapter Inc	/org/lupus-foundation-of-america-heartland-chapter-inc
Pet Missouri - Columbia Inc	/org/pet-missouri-columbia-inc
United Pentecostal Church International Inc	/org/united-pentecostal-church-international-inc-7
Liberty Symphony Orchestra Inc.	/org/liberty-symphony-orchestra-inc
Chain Of Hope Kc	/org/chain-of-hope-kc
Damascus Road	/org/damascus-road-1
CASTAWAY ANIMALS RESCUE EFFORT  (C.A.R.E. Animal Rescue)	/org/castaway-animals-rescue-effort-c-a-r-e-animal-rescue
Central Institute For The Deaf Alumni Association	/org/central-institute-for-the-deaf-alumni-association
Studio Place dba The Studio Place	/org/studio-place-dba-the-studio-place
Small World Adoption Foundation Of Missouri Inc	/org/small-world-adoption-foundation-of-missouri-inc
Apostles To The Orphans	/org/apostles-to-the-orphans
Masters Peace Clinic Of Hope	/org/masters-peace-clinic-of-hope
Lake Of The Ozarks Idiots Club Inc	/org/lake-of-the-ozarks-idiots-club-inc
Socialheart Inc	/org/socialheart-inc
A PLACE CALLED HOME	/org/a-place-called-home-3
Royal Way Ministries, Inc.	/org/royal-way-ministries-inc
Childrens Miracle Network Of Greater St Louis	/org/childrens-miracle-network-of-greater-st-louis
United Gospel Rescue Mission, Inc.	/org/united-gospel-rescue-mission-inc
South Central Missouri Community Action Agency	/org/south-central-missouri-community-action-agency
Missouri Youth Cricket Association	/org/missouri-youth-cricket-association
Community Animal Protection Agency	/org/community-animal-protection-agency
JUNIOR AUXILIARY OF TANEY COUNTY MISSOURI INC	/org/junior-auxiliary-of-taney-county-missouri-inc
Kansas City Chapter Of Young Audiences Inc	/org/kansas-city-chapter-of-young-audiences-inc
Arc Of The Ozarks	/org/arc-of-the-ozarks
Kansas City Metropolitan Crime Commission Inc	/org/kansas-city-metropolitan-crime-commission-inc
Kansas City Consensus	/org/kansas-city-consensus
Kansas CityCARE Clinic	/org/kansas-citycare-clinic
Capital Arts	/org/capital-arts
Kirkwood Historical Society	/org/kirkwood-historical-society
L I F E Inc	/org/l-i-f-e-inc
OPTIMIST INTERNATIONAL FOUNDATION	/org/optimist-international-foundation
North East Community Action Corporation	/org/north-east-community-action-corporation
COMMUNITY BLOOD CENTER OF THE OZARKS	/org/community-blood-center-of-the-ozarks
Principle Foundation	/org/principle-foundation
Pcrmc Health Services Inc	/org/pcrmc-health-services-inc
Children's Center for the Visually Impaired (CCVI)	/org/childrens-center-for-the-visually-impaired-ccvi
Restore Ministries Inc	/org/restore-ministries-inc
Independence Center	/org/independence-center
Pike County Council Concern	/org/pike-county-council-concern
Humanitri	/org/humanitri
International Association Of Administrative Professionals	/org/international-association-of-administrative-professionals_536241
Christian County Humane Society Inc	/org/christian-county-humane-society-inc_536823
St Louis Childrens Choirs	/org/st-louis-childrens-choirs
Luxenhaus Farm German Heritage Foundation	/org/luxenhaus-farm-german-heritage-foundation
Stained Glass Players	/org/stained-glass-players
National Chronic Fatigue Syndrome And Fibromyalgia Association	/org/national-chronic-fatigue-syndrome-and-fibromyalgia-association
Living Word Christian School	/org/living-word-christian-school
Ronald Mcdonald House Charities Of The Four States	/org/ronald-mcdonald-house-charities-of-the-four-states
OZARK MOUNTAIN PLAYERS INC	/org/ozark-mountain-players-inc
Nsi-Louisiana Project	/org/nsi-louisiana-project
United Fund Of Cuivre Township Inc	/org/united-fund-of-cuivre-township-inc
Serendipity And Friends	/org/serendipity-and-friends
Parents Advocating Challenging Education	/org/parents-advocating-challenging-education
Connections to Success	/org/connections-to-success
GENERAL COUNCIL OF THE ASSEMBLIES OF GOD	/org/general-council-of-the-assemblies-of-god-3
Veterans Advocacy Foundation Inc	/org/veterans-advocacy-foundation-inc
Salvation Army	/org/salvation-army-5
Ladies Full Gospel Fellowship International	/org/ladies-full-gospel-fellowship-international_1199283
Agape House	/org/agape-house-5
CENTER FOR SURVIVORS OF TORTURE AND WAR TRAUMA	/org/center-for-survivors-of-torture-and-war-trauma
White River Valley Electric Trust Inc	/org/white-river-valley-electric-trust-inc
American Jazz Museum	/org/american-jazz-museum
Bridging The Gap Inc	/org/bridging-the-gap-inc-4
Charlotte Street Foundation	/org/charlotte-street-foundation
Laura Anderson Ministries	/org/laura-anderson-ministries
Nsi-Hannibal-Riverbluff	/org/nsi-hannibal-riverbluff
LITTLE PATRIOTS EMBRACED INC	/org/little-patriots-embraced-inc
Coalition For Animal Rescue And Education	/org/coalition-for-animal-rescue-and-education
EQUINE-ASSISTED THERAPY INC	/org/equine-assisted-therapy-inc-1
Shannon Foundation	/org/shannon-foundation-2
Paul Prince Ministries Incorporated	/org/paul-prince-ministries-incorporated
Best Foot Forward	/org/best-foot-forward
Pjs Pet Guardians	/org/pjs-pet-guardians
All Nations Family Inc	/org/all-nations-family-inc
Aset Foundation	/org/aset-foundation
CULTURAL LEADERSHIP INC	/org/cultural-leadership-inc
HEALING HOUSE INC	/org/healing-house-inc-2
Junior Trojan Football	/org/junior-trojan-football
Council On American-Islamic Relations-St Louis Inc	/org/council-on-american-islamic-relations-st-louis-inc
Westie Rescue Of Missouri Inc	/org/westie-rescue-of-missouri-inc
New Life Project	/org/new-life-project
Nuclear Space Technology Institute Inc	/org/nuclear-space-technology-institute-inc
Arts Council of Metropolitan Kansas City	/org/arts-council-of-metropolitan-kansas-city
Lifeway Center Inc	/org/lifeway-center-inc
GODS WORD FOR THE NATIONS	/org/gods-word-for-the-nations
Park University	/org/park-university
NORTHLAND THERAPEUTIC RIDING CENTER	/org/northland-therapeutic-riding-center
ProNet International Gifts & Scholarships, 501c3	/org/pronet-international-gifts-scholarships-501c3
National Health Forum Inc	/org/national-health-forum-inc
Inobtr	/org/inobtr
Pike County Connections	/org/pike-county-connections
Florissant Valley Jaycees Foundation	/org/florissant-valley-jaycees-foundation
Ozark Haven Rescue	/org/ozark-haven-rescue
Joshua Media Ministry	/org/joshua-media-ministry
Care Counseling Inc	/org/care-counseling-inc
Tauheed Youth Development Life Skills Corporation	/org/tauheed-youth-development-life-skills-corporation
Habitat For Neighborhood Business	/org/habitat-for-neighborhood-business
Be The Change Volunteers	/org/be-the-change-volunteers
Sunny Hill Inc	/org/sunny-hill-inc
Live At Peace Ministries	/org/live-at-peace-ministries
Newborns In Need Inc	/org/newborns-in-need-inc
Child Evangelism Fellowship Inc	/org/child-evangelism-fellowship-inc_648832
People to People International	/org/people-to-people-international-27
Rock Hollow Youth Ranch	/org/rock-hollow-youth-ranch
St. Stephen ECD & Preschool, Inc.	/org/st-stephen-ecd-preschool-inc
Circle Of Concern	/org/circle-of-concern
Restart Inc	/org/restart-inc-1
Foundation for Children With Cancer	/org/foundation-for-children-with-cancer
FABRY SUPPORT & INFORMATION GROUP	/org/fabry-support-information-group
Nsi-New London Project	/org/nsi-new-london-project
Wayside Waifs Inc	/org/wayside-waifs-inc
Vasculitis Foundation	/org/vasculitis-foundation
Disabled Citizens Alliance For Independence Foundation Inc	/org/disabled-citizens-alliance-for-independence-foundation-inc
Epilepsy Foundation of Missouri and Kansas	/org/epilepsy-foundation-of-missouri-and-kansas
Northland Meals On Wheels Inc	/org/northland-meals-on-wheels-inc
Thank You Walt Disney Inc	/org/thank-you-walt-disney-inc
Family Support Network	/org/family-support-network
Community Assistance Council Inc	/org/community-assistance-council-inc-1
PARALYZED VETERANS OF AMERICA Gateway Chapter	/org/paralyzed-veterans-of-america-gateway-chapter
Turkish American Cultural Alliance- St Louis In Missouri	/org/turkish-american-cultural-alliance-st-louis-in-missouri
ANGELS' ARMS	/org/angels-arms
Eagle Wings Ministries	/org/eagle-wings-ministries-1
Pike County Sheltered Workshop Inc	/org/pike-county-sheltered-workshop-inc
Literacy Kansas City	/org/literacy-kansas-city
Prison Performing Arts	/org/prison-performing-arts
Habitat For Humanity Of Kansas City	/org/habitat-for-humanity-of-kansas-city
Edgewood Childrens Center	/org/edgewood-childrens-center
St Martins Child Center	/org/st-martins-child-center
Spina Bifida Association of Greater St. Louis Parents Association	/org/spina-bifida-association-of-greater-st-louis-parents-association
Willows Way Inc	/org/willows-way-inc
International Society For Krishna Consciousness Of St Louis Inc	/org/international-society-for-krishna-consciousness-of-st-louis-inc
SHEPHERDS CENTER OF WEBSTER KIRKWOOD INC	/org/shepherds-center-of-webster-kirkwood-inc
Mega Foundation Inc	/org/mega-foundation-inc
ROOM AT THE INN	/org/room-at-the-inn-2
Branson High School Project Graduation Inc	/org/branson-high-school-project-graduation-inc
Green Hills Animal Shelter Inc	/org/green-hills-animal-shelter-inc
Kindness In A Box	/org/kindness-in-a-box
The Independent Living Center Inc	/org/the-independent-living-center-inc
Saint Charles County Golden Games Association	/org/saint-charles-county-golden-games-association
Nsi-Lincoln County	/org/nsi-lincoln-county
Wentzville Wildcats Youth Football Association	/org/wentzville-wildcats-youth-football-association
Missouri Council Of The Christian Union	/org/missouri-council-of-the-christian-union
Builders Of Life Restoration Center	/org/builders-of-life-restoration-center
House Rabbit Society Of Missouri	/org/house-rabbit-society-of-missouri
Breakdown Stl	/org/breakdown-stl
The Kansas City Boys Choir A Not- For-Profit Corporation	/org/the-kansas-city-boys-choir-a-not-for-profit-corporation
Tycor Community Development Corp Inc	/org/tycor-community-development-corp-inc
Heartland Humane Society Of Missouri	/org/heartland-humane-society-of-missouri
Jacobs Well of Kansas City Ministries	/org/jacobs-well-of-kansas-city-ministries
Lesbian Gay Bi Transgender Community Center Of Metro St Louis	/org/lesbian-gay-bi-transgender-community-center-of-metro-st-louis
Star St Louis Avian Rescue Inc	/org/star-st-louis-avian-rescue-inc
Support Dogs Inc	/org/support-dogs-inc
Give Kids A Smile Inc	/org/give-kids-a-smile-inc
St. Louis Area Foodbank, Inc.	/org/st-louis-area-foodbank-inc
Coat-A-Kid Inc	/org/coat-a-kid-inc
Habitat For Humanity International Inc	/org/habitat-for-humanity-international-inc-254
Our Lady Catholic Church	/org/our-lady-catholic-church
The Dental Health Theatre Inc	/org/the-dental-health-theatre-inc
Golden Spur Ministries Inc	/org/golden-spur-ministries-inc
Camp David Of The Ozarks Inc	/org/camp-david-of-the-ozarks-inc
Mercy Health Foundation St Louis	/org/mercy-health-foundation-st-louis
Ozarks Regional Ymca	/org/ozarks-regional-ymca
Inroads Inc	/org/inroads-inc_534332
Redemptorist Social Services Center Inc	/org/redemptorist-social-services-center-inc
Operation Breakthrough Inc	/org/operation-breakthrough-inc
Randolph County Sheltered Industries Inc	/org/randolph-county-sheltered-industries-inc
Raintree Arts Council	/org/raintree-arts-council
Shelbina Arts Council	/org/shelbina-arts-council
Franklin County Dental Network Inc	/org/franklin-county-dental-network-inc
Wild Bird Rehabilitation	/org/wild-bird-rehabilitation
Trail To A Cure Inc	/org/trail-to-a-cure-inc
Fellowship Of Christian Athletes Group Return	/org/fellowship-of-christian-athletes-group-return
Coyote Hill Christian Children's Home	/org/coyote-hill-christian-childrens-home
Disabled Athlete Sports Association	/org/disabled-athlete-sports-association
Grace Hill Settlement House	/org/grace-hill-settlement-house-1
Shiloh Christian Childrens Ranch Inc	/org/shiloh-christian-childrens-ranch-inc
AGAPE CHRISTIAN COUNSELING SERVICES	/org/agape-christian-counseling-services
A & M Home Health Inc	/org/a-m-home-health-inc
If Not For Grace Ministries	/org/if-not-for-grace-ministries
TASK FORCE OMEGA OF MISSOURI	/org/task-force-omega-of-missouri
Lees Summit Soccer Association	/org/lees-summit-soccer-association
Dbldoc Tricycle Racing Inc	/org/dbldoc-tricycle-racing-inc
Southern Webster County Food Pantry	/org/southern-webster-county-food-pantry
SPRINGFIELD ANIMAL ADVOCACY FOUNDATION	/org/springfield-animal-advocacy-foundation
American Rehabilitation Ministry Inc	/org/american-rehabilitation-ministry-inc
Historic Riverboat Preservation Association	/org/historic-riverboat-preservation-association
49 Xxxxy Fund	/org/49-xxxxy-fund
Second Chapter Life Center	/org/second-chapter-life-center
Della Lamb Community Services	/org/della-lamb-community-services
Presser Hall Restoration Society	/org/presser-hall-restoration-society
Womens Crisis Center Of Taney County Inc	/org/womens-crisis-center-of-taney-county-inc
Helping Hands And Horses Inc	/org/helping-hands-and-horses-inc
Branson Veterans Task Force Inc	/org/branson-veterans-task-force-inc
Champ Assistance Dogs	/org/champ-assistance-dogs
Founders Foundation Trust Fund Inc	/org/founders-foundation-trust-fund-inc
Interfaith Community Services Inc	/org/interfaith-community-services-inc
East Missouri Action Agency Inc	/org/east-missouri-action-agency-inc
His Childrens Camp Inc	/org/his-childrens-camp-inc
Women's Support and Community Services dba Safe Connections	/org/womens-support-and-community-services-dba-safe-connections
Lakeview Christian Academy	/org/lakeview-christian-academy
Literacy Volunteers Of America - Laclede Literacy Council	/org/literacy-volunteers-of-america-laclede-literacy-council
Baptist Home Inc	/org/baptist-home-inc
Allied Arts Council of St. Joseph, MO Inc.	/org/allied-arts-council-of-st-joseph-mo-inc
St Francois County Woodlawn Cemetery Association	/org/st-francois-county-woodlawn-cemetery-association
Kamens' Angels, Inc.,	/org/kamens-angels-inc
STLBTA	/org/stlbta
Lewis County Farm Bureau	/org/lewis-county-farm-bureau-1
Web Innovation & Technology Services Inc	/org/web-innovation-technology-services-inc
Golden Years Apartments Inc	/org/golden-years-apartments-inc
Arnold Food Pantry	/org/arnold-food-pantry
Fraternal Order Of Eagles	/org/fraternal-order-of-eagles-2130
The St Louis Celestial Intervention Agency Inc	/org/the-st-louis-celestial-intervention-agency-inc
MACON COUNTY SHELTERED WORKSHOP INC	/org/macon-county-sheltered-workshop-inc
Tdl Country Club Inc	/org/tdl-country-club-inc
Oakdell Homes Association	/org/oakdell-homes-association
Savannah Housing Inc	/org/savannah-housing-inc
United States Army Divers Association	/org/united-states-army-divers-association
Atai Orphanage Fund	/org/atai-orphanage-fund
Enteam Organization	/org/enteam-organization
Missouri Contemporary Ballet	/org/missouri-contemporary-ballet
Order Of The Eastern Star Of Missouri Grand Chapter	/org/order-of-the-eastern-star-of-missouri-grand-chapter-51
Bubbling Springs Conference And Retreat Center Inc	/org/bubbling-springs-conference-and-retreat-center-inc
Chesapeake Wildlife Sanctuary Inc	/org/chesapeake-wildlife-sanctuary-inc
Ahniyvwiya Inc	/org/ahniyvwiya-inc
Gates-To-Heaven Inc	/org/gates-to-heaven-inc
Jewish Community Center	/org/jewish-community-center-3
NOBLE HORSE RESCUE	/org/noble-horse-rescue
Hope Center Of Pike County	/org/hope-center-of-pike-county
Kappa Sigma Fraternity	/org/kappa-sigma-fraternity-284
Missouri River Relief	/org/missouri-river-relief
Christian Childrens Ministry Of Tri County	/org/christian-childrens-ministry-of-tri-county
St Louis Volunteen.com	/org/st-louis-volunteen-com
Lay Renewal Ministries Inc	/org/lay-renewal-ministries-inc
American Red Cross	/org/american-red-cross_30709
Necc Personnel Club	/org/necc-personnel-club
Jamestown New Horizons	/org/jamestown-new-horizons
Dent County Animal Welfare Society	/org/dent-county-animal-welfare-society
Concerned Citizenry To Save Lincoln School Inc	/org/concerned-citizenry-to-save-lincoln-school-inc
Midwest Biomedical Research Foundation	/org/midwest-biomedical-research-foundation
Truman Lake Community Foundation	/org/truman-lake-community-foundation
Boys And Girls Clubs Of The Columbia Area	/org/boys-and-girls-clubs-of-the-columbia-area
Ella's Hope	/org/ellas-hope-1
Multiple Options Inc	/org/multiple-options-inc
African American Chamber Of Commerce Of Metropolitan St Louis	/org/african-american-chamber-of-commerce-of-metropolitan-st-louis
Coast Guard Auxiliary Association Inc	/org/coast-guard-auxiliary-association-inc
All American Conference To Combat Communism	/org/all-american-conference-to-combat-communism
Child Abuse Prevention Association	/org/child-abuse-prevention-association
Lemay Child And Family Center	/org/lemay-child-and-family-center
FATHERS SUPPORT CENTER ST LOUIS	/org/fathers-support-center-st-louis
NEW AGE TRUTH OF MISSOURI	/org/new-age-truth-of-missouri
Toastmasters International	/org/toastmasters-international-7568
Kansas City Repertory Theatre Inc	/org/kansas-city-repertory-theatre-inc
Paul Mesner Puppets, Inc.	/org/paul-mesner-puppets-inc
Monroe County Cancer Supporters	/org/monroe-county-cancer-supporters
Kansas City Pet Project	/org/kansas-city-pet-project
Clowder House Foundation Inc	/org/clowder-house-foundation-inc
Friends Of Abilities First Inc	/org/friends-of-abilities-first-inc
Paws 4 Autism	/org/paws-4-autism
Helping Hands Food Pantry	/org/helping-hands-food-pantry-1
Ark Of The Covenant Foundation	/org/ark-of-the-covenant-foundation
Republic Paw Pantry	/org/republic-paw-pantry
Pages And Chapters	/org/pages-and-chapters
Neosho Youth Basketball Association	/org/neosho-youth-basketball-association
Needy Paws Rescue	/org/needy-paws-rescue-1
Playing For The Cause	/org/playing-for-the-cause
Advocates 4 Animals Pet Food Pantry	/org/advocates-4-animals-pet-food-pantry
Q Foundation For Kids	/org/q-foundation-for-kids
HEALTH HAVEN BOTANICAL GARDENS	/org/health-haven-botanical-gardens
Healing Box Project	/org/healing-box-project
Warriors Heart Foundation	/org/warriors-heart-foundation
Gold Star Wives Of America Inc	/org/gold-star-wives-of-america-inc-27
St Andrews Resources For Seniors	/org/st-andrews-resources-for-seniors-1
Trinity Christian Fellowship Of Neosho	/org/trinity-christian-fellowship-of-neosho
Callao Heritage Society Community Betterment	/org/callao-heritage-society-community-betterment
Center Housing Iii Inc	/org/center-housing-iii-inc
Revival Live Ministries Inc	/org/revival-live-ministries-inc
Willmore Lodge Foundation	/org/willmore-lodge-foundation
History Museum On The Square Inc	/org/history-museum-on-the-square-inc
Embroiderers Guild Of America, Inc.	/org/embroiderers-guild-of-america-inc_30424
Community Day Care Learning Center Inc	/org/community-day-care-learning-center-inc
Wentzville Senior Center Transportation Inc	/org/wentzville-senior-center-transportation-inc
Harvest Food Pantry Of Boone County, Inc.	/org/harvest-food-pantry-of-boone-county-inc
New Beginning Missionary Baptist Church	/org/new-beginning-missionary-baptist-church
Tri-Rivers Family Planning Inc	/org/tri-rivers-family-planning-inc
