org_name	org_url
Missoula Urban Demonstration Project	/org/missoula-urban-demonstration-project
Buffalo Field Campaign	/org/buffalo-field-campaign
Institutes For Journalism & Natural Resources	/org/institutes-for-journalism-natural-resources
Irwin and Florence Rosten Foundation	/org/irwin-and-florence-rosten-foundation
YWAM Mission Builders dba Mission Builders International	/org/ywam-mission-builders-dba-mission-builders-international
Central Asia Institute	/org/central-asia-institute
Watson Children's Shelter, Inc.	/org/watson-childrens-shelter-inc
K9 Care Montana	/org/k9-care-montana
Women's Voices for the Earth	/org/womens-voices-for-the-earth
Missoula Aging Services	/org/missoula-aging-services
St Labre Indian School	/org/st-labre-indian-school
Orphan's Lifeline of Hope International	/org/orphans-lifeline-of-hope-international
Emerson Center for the Arts & Culture	/org/emerson-center-for-the-arts-culture
Hopa Mountain Foundation	/org/hopa-mountain-foundation
St. Patrick Hospital Foundation	/org/st-patrick-hospital-foundation
Seedlings of Change	/org/seedlings-of-change
Intermountain	/org/intermountain
Ecology Project International	/org/ecology-project-international
Western Montana Equine Rescue & Rehabilitation Inc	/org/western-montana-equine-rescue-rehabilitation-inc
Intermountain Opera Bozeman	/org/intermountain-opera-bozeman
The Biomimicry Institute	/org/the-biomimicry-institute
Rezq Dogs	/org/rezq-dogs
Hospice Care Foundation	/org/hospice-care-foundation-1
Vital Ground Foundation Inc	/org/vital-ground-foundation-inc
Sunburst Unlimited Inc	/org/sunburst-unlimited-inc
Imagine Missoula	/org/imagine-missoula
U & I Nonprofit Corporation	/org/u-i-nonprofit-corporation
The Rim Rock Humane Society Inc	/org/the-rim-rock-humane-society-inc
Valley Veterans Service Center	/org/valley-veterans-service-center
Glacier National Park Conservancy	/org/glacier-national-park-conservancy
Camp Patriot Corp	/org/camp-patriot-corp
Compassion Tanzania	/org/compassion-tanzania
United in Light, Inc.	/org/united-in-light-inc
Pet Paw-See Inc	/org/pet-paw-see-inc
Their Last Best Place	/org/their-last-best-place
Alberta Bair Theater Corporation	/org/alberta-bair-theater-corporation
Greater Yellowstone Coalition	/org/greater-yellowstone-coalition
Eagle Mount Billings	/org/eagle-mount-billings
Northern Plains Resource Council	/org/northern-plains-resource-council-10
Blue Mountain Clinic Inc	/org/blue-mountain-clinic-inc
Basset Rescue Of Montana	/org/basset-rescue-of-montana
World Museum of Mining Inc	/org/world-museum-of-mining-inc
Big Sky Senior Services, Inc. DBA Senior Helping Hands and Prevention of Elder Abuse	/org/big-sky-senior-services-inc-dba-senior-helping-hands-and-prevention-of-elde
Eagle Mount Great Falls	/org/eagle-mount-great-falls
Help For Homeless Pets Inc	/org/help-for-homeless-pets-inc
HAMILTON PLAYERS INC	/org/hamilton-players-inc
Eleanores Project Inc.	/org/eleanores-project-inc
Swan View Coalition Inc	/org/swan-view-coalition-inc
Montana Environmental Information Center Inc	/org/montana-environmental-information-center-inc
Catalyst For Kids	/org/catalyst-for-kids
American Prairie Reserve	/org/american-prairie-reserve
Animeals	/org/animeals
Heroes and Horses	/org/heroes-and-horses
Northwest Montana Historical Society Inc	/org/northwest-montana-historical-society-inc
Bitteroot Therapeutic Riding	/org/bitteroot-therapeutic-riding
Sanders County Arts Council	/org/sanders-county-arts-council
REACH OUT & CARE WHEELS INC	/org/reach-out-care-wheels-inc
Praise Chapel Troy Montana	/org/praise-chapel-troy-montana
Animal Foundation Of Great Falls Montana	/org/animal-foundation-of-great-falls-montana
Billings Food Bank Inc	/org/billings-food-bank-inc
FAMILY PROMISE OF GALLATIN VALLEY INC	/org/family-promise-of-gallatin-valley-inc
Human Resource Development Council Of District Ix Inc	/org/human-resource-development-council-of-district-ix-inc
Foys To Blacktail Trails Inc	/org/foys-to-blacktail-trails-inc
Rocky Mountain Elk Foundation Inc	/org/rocky-mountain-elk-foundation-inc-254
Head Start Inc	/org/head-start-inc
Montana Food Bank Network Inc.	/org/montana-food-bank-network-inc
Indias Hope	/org/indias-hope
Five Valleys Land Trust Inc	/org/five-valleys-land-trust-inc
Jeannette Rankin Peace Resource Center	/org/jeannette-rankin-peace-resource-center
PROJECT PHILANTHROPY	/org/project-philanthropy
Craighead Environmental Research Institute	/org/craighead-environmental-research-institute
Polar Bears International	/org/polar-bears-international
Civil Air Patrol	/org/civil-air-patrol_178427
Red Feather Development Group	/org/red-feather-development-group
Bitter Root Land Trust Inc	/org/bitter-root-land-trust-inc
BITTERROOTERS FOR PLANNING	/org/bitterrooters-for-planning
Prickly Pear Land Trust	/org/prickly-pear-land-trust
Women Graduates-Usa	/org/women-graduates-usa
Eagle Mount Bozeman	/org/eagle-mount-bozeman
GALLATIN VALLEY LAND TRUST	/org/gallatin-valley-land-trust
Hope Africa Collective Inc	/org/hope-africa-collective-inc
Montana Innocence Project	/org/montana-innocence-project
THE EMERGENT INSTITUTE	/org/the-emergent-institute
The Policy Institute	/org/the-policy-institute
Bitter Root Valley Historical Society	/org/bitter-root-valley-historical-society
BUTTE RESCUE MISSION	/org/butte-rescue-mission
Education Foundation For Billings Public Schools	/org/education-foundation-for-billings-public-schools
Montana School For The Deaf And Blind Foundation	/org/montana-school-for-the-deaf-and-blind-foundation
MONTANA NONPROFIT ASSOCIATION INC	/org/montana-nonprofit-association-inc
Northwest Montana Head Start Inc	/org/northwest-montana-head-start-inc
Rocky Mountain College	/org/rocky-mountain-college
Montana Large Animal Sanctuary & Rescue, Inc.	/org/montana-large-animal-sanctuary-rescue-inc
Flathead Land Trust Inc	/org/flathead-land-trust-inc
YWCA OF BILLINGS ENDOWMENT FOUNDATION INC	/org/ywca-of-billings-endowment-foundation-inc
Montana Project Healing Waters Fly Fishing Inc	/org/montana-project-healing-waters-fly-fishing-inc
Zonta International	/org/zonta-international-290
KOOTENAI VALLEY CHRISTIAN SCHOOL INC	/org/kootenai-valley-christian-school-inc
Glacier Mountaineering Society	/org/glacier-mountaineering-society
Silver Bow Montessori School Inc	/org/silver-bow-montessori-school-inc
Alberts Angel Fund	/org/alberts-angel-fund
New Dawn Mt Farm Sanctuary	/org/new-dawn-mt-farm-sanctuary
MONTANA LEGAL SERVICES ASSOCIATION	/org/montana-legal-services-association
Project WET Foundation	/org/project-wet-foundation
Payden Memorial Foundation Inc	/org/payden-memorial-foundation-inc
North West Montana Veterans Stand Down	/org/north-west-montana-veterans-stand-down
Lewistown Art Center	/org/lewistown-art-center
Big Horn County Historical Society	/org/big-horn-county-historical-society
Spirit At Play Inc	/org/spirit-at-play-inc
BITTER ROOT RESOURCE CONSERVATION AND DEVELOPMENT AREA INCORPORATED	/org/bitter-root-resource-conservation-and-development-area-incorporated
Society For Preservation & Encourmt Of Barbershop Quartet Singing Amer	/org/society-for-preservation-encourmt-of-barbershop-quartet-singing-amer-81
Habitat For Humanity International Inc	/org/habitat-for-humanity-international-inc-1405
Montana Land Reliance	/org/montana-land-reliance
TIBETAN CHILDRENS EDUCATION FOUNDATION	/org/tibetan-childrens-education-foundation
Garage Theater	/org/garage-theater
Bob Marshall Wilderness Foundation Inc	/org/bob-marshall-wilderness-foundation-inc
Northern Plains Resource Council	/org/northern-plains-resource-council-12
Beartooth Mountain Pastoral Counseling	/org/beartooth-mountain-pastoral-counseling
Kitty Keepers	/org/kitty-keepers
Rocky Boy Health Board	/org/rocky-boy-health-board
FOOTLOOSE MONTANA	/org/footloose-montana
Montana Horse Sanctuary	/org/montana-horse-sanctuary
Henry Brandt Ministries Inc	/org/henry-brandt-ministries-inc
Flathead Spay & Neuter Task Force Inc	/org/flathead-spay-neuter-task-force-inc
WILD SKIES RAPTOR CENTER	/org/wild-skies-raptor-center
Cruise 4 Kids	/org/cruise-4-kids
The Parenting Place	/org/the-parenting-place
Ramsey Keller Memorial	/org/ramsey-keller-memorial
Iqra Fund	/org/iqra-fund
Thrive Inc	/org/thrive-inc-3
The Bozeman Area Community Foundation	/org/the-bozeman-area-community-foundation
All Mosta Ranch Montana	/org/all-mosta-ranch-montana
Tamarack Grief Resource Center Inc	/org/tamarack-grief-resource-center-inc
St Vincent Healthcare Foundation	/org/st-vincent-healthcare-foundation
Humane Society Of Western Montana	/org/humane-society-of-western-montana
Bitterroot Valley Education Cooperative	/org/bitterroot-valley-education-cooperative
Water Of Life Radio	/org/water-of-life-radio
Missoula Community Chorus Inc	/org/missoula-community-chorus-inc
Montana Mediation Association	/org/montana-mediation-association
Habitat For Humanity International Inc	/org/habitat-for-humanity-international-inc-1410
Montana Animal Care Association	/org/montana-animal-care-association
Billings District Council	/org/billings-district-council
Ravalli County Council On Aging	/org/ravalli-county-council-on-aging
Betsileo Development	/org/betsileo-development
Alternative Energy Resources Organization	/org/alternative-energy-resources-organization
Judith Basin Senior Citizens Center	/org/judith-basin-senior-citizens-center
Frances Mahon Deaconess Hospital Foundation Inc	/org/frances-mahon-deaconess-hospital-foundation-inc
Stillwater Youth Center Inc	/org/stillwater-youth-center-inc
Elkhorn Mountain Health Services Inc	/org/elkhorn-mountain-health-services-inc
St Johns Lutheran Hospital Foundation Inc	/org/st-johns-lutheran-hospital-foundation-inc
Junior Achievement Inc	/org/junior-achievement-inc
Canyon Ferry Road Baptist Church	/org/canyon-ferry-road-baptist-church
International Federation Of Fly Fishers Inc	/org/international-federation-of-fly-fishers-inc-80
Jungle Gym Daycare Inc	/org/jungle-gym-daycare-inc
Phillips County Hospital Assn	/org/phillips-county-hospital-assn
American Planning Association	/org/american-planning-association
Garfield County Health Center Inc	/org/garfield-county-health-center-inc
Montana Community Development Corporation	/org/montana-community-development-corporation
Womens International Bowling Congress Inc	/org/womens-international-bowling-congress-inc_9954
Fellowship Of Christian Athletes	/org/fellowship-of-christian-athletes_9871
Keep Montana Green Association	/org/keep-montana-green-association
Colstrip Church Of Christ	/org/colstrip-church-of-christ
Yellowstone Health Partnership	/org/yellowstone-health-partnership
Christs Church In Missoula	/org/christs-church-in-missoula
Friends Of The Missoula Public Library	/org/friends-of-the-missoula-public-library
Class Of 61 Inc	/org/class-of-61-inc
National Society Of The Daughters Of The American Revolution	/org/national-society-of-the-daughters-of-the-american-revolution-52
Church Women United Of Columbia Falls	/org/church-women-united-of-columbia-falls
Toastmasters International	/org/toastmasters-international_3839
Womens International Bowling Congress Inc	/org/womens-international-bowling-congress-inc_9948
Friends Of The Shelter Tobacco Valley Animal Shelter Inc	/org/friends-of-the-shelter-tobacco-valley-animal-shelter-inc
Mission Valley Friends Of The Arts	/org/mission-valley-friends-of-the-arts
Toastmistress Clubs International Toastmistress Club Of Butte	/org/toastmistress-clubs-international-toastmistress-club-of-butte
North Valley Food Bank Inc	/org/north-valley-food-bank-inc
Becky Eiker Foundation	/org/becky-eiker-foundation
Council For The Arts Inc Lincoln Mt Eighth Ave	/org/council-for-the-arts-inc-lincoln-mt-eighth-ave
Helena Community Gardens	/org/helena-community-gardens
Toastmasters International	/org/toastmasters-international-8281
Christian Renewal Inc	/org/christian-renewal-inc
Montana Congress Of Parents Teachers Students	/org/montana-congress-of-parents-teachers-students-49
Nami-Billings	/org/nami-billings
Sweet Medical Center Inc	/org/sweet-medical-center-inc
Lords Church Ministries Inc	/org/lords-church-ministries-inc
Pondera History Association	/org/pondera-history-association
Whirling Disease Foundation Inc	/org/whirling-disease-foundation-inc
CARTER COUNTY GEOLOGICAL SOCIETY	/org/carter-county-geological-society
Little League Baseball Inc	/org/little-league-baseball-inc-276
Little League Baseball Inc 4260119	/org/little-league-baseball-inc-4260119
Trout Unlimited	/org/trout-unlimited-308
Women Work The National Network For Womens Employement Inc	/org/women-work-the-national-network-for-womens-employement-inc_27332
Womens International Bowling Congress	/org/womens-international-bowling-congress_27943
American Guild Of Organists	/org/american-guild-of-organists-163
Missoula Ski Education Foundation	/org/missoula-ski-education-foundation
Pondera Medical Center	/org/pondera-medical-center
Beaverhead County Museum Association	/org/beaverhead-county-museum-association
Rockmont Inc	/org/rockmont-inc
Conrad Christian Reformed Church	/org/conrad-christian-reformed-church
World Wide Film Expedition Inc	/org/world-wide-film-expedition-inc
Partnership For Animal Welfare Humane Society	/org/partnership-for-animal-welfare-humane-society
The Bread Of Life Soup Kitchen Inc	/org/the-bread-of-life-soup-kitchen-inc
Richland County Food Bank Inc	/org/richland-county-food-bank-inc
Womens International Bowling Congress Inc	/org/womens-international-bowling-congress-inc_36703
Central Montana Head Start Inc	/org/central-montana-head-start-inc
Northern Rockies Heritage Center Inc	/org/northern-rockies-heritage-center-inc
Grace Gospel Church	/org/grace-gospel-church
Women's Aglow Fellowship International, Inc.	/org/womens-aglow-fellowship-international-inc_44669
Great Falls Public Library Foundation	/org/great-falls-public-library-foundation
Liberty County Health Planning Council Inc	/org/liberty-county-health-planning-council-inc
Fellowship Alliance Church	/org/fellowship-alliance-church
American Fisheries Society	/org/american-fisheries-society-46
Mission Valley Senior Citizens Inc	/org/mission-valley-senior-citizens-inc
United Way Of Hill County	/org/united-way-of-hill-county
Belle Creek Community Church	/org/belle-creek-community-church
Lukes 100 Inc	/org/lukes-100-inc
Cardwell Community Church Inc	/org/cardwell-community-church-inc
Quarter Century Club Inc	/org/quarter-century-club-inc
Tibetan Language Institute	/org/tibetan-language-institute
Touch Factor Foundation	/org/touch-factor-foundation
Toastmasters International	/org/toastmasters-international_60134
International Church Of The Foursquare Gospel	/org/international-church-of-the-foursquare-gospel-143
National Indian School Board Association Inc	/org/national-indian-school-board-association-inc
Wings Inc	/org/wings-inc
Child Life Safety Skills, Inc.	/org/child-life-safety-skills-inc
Bozeman Summit School Inc	/org/bozeman-summit-school-inc
Spirit Of The Valley Metropolitan Community Church	/org/spirit-of-the-valley-metropolitan-community-church
Committee For The Restoration Of The Eye Of The Needle	/org/committee-for-the-restoration-of-the-eye-of-the-needle
Rocky Mountain Ski Race Officials Inc	/org/rocky-mountain-ski-race-officials-inc
Montana Indian Art And Culture Association, Inc.	/org/montana-indian-art-and-culture-association-inc
Toastmistress Clubs International	/org/toastmistress-clubs-international
Knights Templar Educational Foundation Of The Grand Encampment	/org/knights-templar-educational-foundation-of-the-grand-encampment-33
Central Christian Church	/org/central-christian-church-97
Montana Association Of Weavers And Spinners	/org/montana-association-of-weavers-and-spinners
Sheridan Memorial Hospital Association	/org/sheridan-memorial-hospital-association
Montana 4-H Foundation Inc	/org/montana-4-h-foundation-inc-265
Madison Valley Hospital Association	/org/madison-valley-hospital-association
Young Womens Christian Assn	/org/young-womens-christian-assn-5
Vineyard Christian Fellowship Of Great Falls	/org/vineyard-christian-fellowship-of-great-falls
Boy Scouts Of America	/org/boy-scouts-of-america-526
Holy Rosary Healthcare	/org/holy-rosary-healthcare
Montana Congress Of Parents Teachers Students	/org/montana-congress-of-parents-teachers-students_9912
Trinity Lutheran Church	/org/trinity-lutheran-church-647
Toastmasters International	/org/toastmasters-international_3836
Newberry Family Charitable Foundation	/org/newberry-family-charitable-foundation
Great Falls Community Concert Association	/org/great-falls-community-concert-association
Child Start Inc	/org/child-start-inc
Missoula Nordic Ski Club	/org/missoula-nordic-ski-club
Chief Dull Knife College	/org/chief-dull-knife-college
Gallatin Park County Youth Guidance Home, Inc.	/org/gallatin-park-county-youth-guidance-home-inc
Bitterroot Christian Ministries Inc	/org/bitterroot-christian-ministries-inc
Music In Montana Summer Festival	/org/music-in-montana-summer-festival
Havre Day Activity Center Inc	/org/havre-day-activity-center-inc
Chinook Community Chest	/org/chinook-community-chest
Rapelje Evangelical Church	/org/rapelje-evangelical-church
Emmaus Campus Ministry	/org/emmaus-campus-ministry
Montana United Indian Association	/org/montana-united-indian-association
Wicks Lane Baptist Church	/org/wicks-lane-baptist-church
Skyline Sportsman Association	/org/skyline-sportsman-association
Ryland K M Foote Memorial Trust	/org/ryland-k-m-foote-memorial-trust
Missoula Senior Citizens	/org/missoula-senior-citizens
Memorial Ambulance Of Fort Benton Montana	/org/memorial-ambulance-of-fort-benton-montana
Church Universal And Triumphant	/org/church-universal-and-triumphant-7
Montana Wildlife Federation	/org/montana-wildlife-federation
Western Montana Fund Raisers Association	/org/western-montana-fund-raisers-association
Unity Church Of Truth	/org/unity-church-of-truth
Rocky Mountain Bible Mission	/org/rocky-mountain-bible-mission
Montana Air National Guard Family Support Fund Fsp	/org/montana-air-national-guard-family-support-fund-fsp
Harvest Springs Community Church	/org/harvest-springs-community-church
Trinity Lutheran Church	/org/trinity-lutheran-church-635
Fort Courage Child Care Inc	/org/fort-courage-child-care-inc
Flathead Community Concert Association	/org/flathead-community-concert-association
The Ough Charitable Trust	/org/the-ough-charitable-trust
Rocky Mountain District Of The Christian And Missionary Alliance	/org/rocky-mountain-district-of-the-christian-and-missionary-alliance
St Johns Lutheran Ministries Inc	/org/st-johns-lutheran-ministries-inc
Sweet Grass Community Hospital Inc	/org/sweet-grass-community-hospital-inc
Teton County Council On Aging	/org/teton-county-council-on-aging
Valley Community Emergency Food Bank Inc	/org/valley-community-emergency-food-bank-inc
Evangelical Church Of North America	/org/evangelical-church-of-north-america
Intermountain Christian Fellowship Inc	/org/intermountain-christian-fellowship-inc
Kairos Youth Services	/org/kairos-youth-services
Montana Congress Of Parents Teachers Students	/org/montana-congress-of-parents-teachers-students-56
Native American Senior Citizen Council	/org/native-american-senior-citizen-council
Yellowstone Bluegrass Association Inc	/org/yellowstone-bluegrass-association-inc
Bozeman Christian Reformed Church	/org/bozeman-christian-reformed-church
Anaconda Local Development Corp	/org/anaconda-local-development-corp
Bozeman Shelter Care Facility	/org/bozeman-shelter-care-facility
Realization In Truth Church Inc	/org/realization-in-truth-church-inc
Foundation For Endowment Of Faith Lutheran Church Inc	/org/foundation-for-endowment-of-faith-lutheran-church-inc
Montanans Improving Tax Administration	/org/montanans-improving-tax-administration
Billings Elks Memorial Fund	/org/billings-elks-memorial-fund
Paint Up Montana, Inc.	/org/paint-up-montana-inc
Tots Toys & Tales, Inc.	/org/tots-toys-tales-inc
Alzheimer's Disease And Related Disorders Association	/org/alzheimers-disease-and-related-disorders-association_66540
Sidney Gymnastics Club	/org/sidney-gymnastics-club
Continental Public Land Trust	/org/continental-public-land-trust
Skyword Ministries Over Montana Inc	/org/skyword-ministries-over-montana-inc
Broadview	/org/broadview-1
Plains Library Foundation	/org/plains-library-foundation
Centers For Spiritual Living	/org/centers-for-spiritual-living-177
Montana Environmental Education Association Inc	/org/montana-environmental-education-association-inc
Montana Academy Of Sciences	/org/montana-academy-of-sciences
Victory Chapel Ministries Inc	/org/victory-chapel-ministries-inc_66557
Church Of Christ Of Laurel Montana Inc	/org/church-of-christ-of-laurel-montana-inc
Columbia Falls Booster Club Inc	/org/columbia-falls-booster-club-inc
Hellgate Band Parents Inc	/org/hellgate-band-parents-inc
Montana Congress Of Parents Teachers Students	/org/montana-congress-of-parents-teachers-students-41
Youth For Christ Usa Inc	/org/youth-for-christ-usa-inc-91
Fellowship Baptist Church	/org/fellowship-baptist-church-58
Big Sandy Historical Society Inc	/org/big-sandy-historical-society-inc
Cabinet Resource Group	/org/cabinet-resource-group
Madison Valley Medical Center Foundation Inc	/org/madison-valley-medical-center-foundation-inc
Owl Research Institute Inc	/org/owl-research-institute-inc
Montana Associated Physicians Health Care Foundation, Inc.	/org/montana-associated-physicians-health-care-foundation-inc
Funshine Preschool	/org/funshine-preschool
Hollowtop Senior Citizens Club	/org/hollowtop-senior-citizens-club
Clark Fork Arena	/org/clark-fork-arena
Mt Powell Baptist Church	/org/mt-powell-baptist-church
Culbertson Museum Inc	/org/culbertson-museum-inc
Alliance For Youth Inc	/org/alliance-for-youth-inc
Missoula Pta Council	/org/missoula-pta-council
Libby Community Interagencies Inc	/org/libby-community-interagencies-inc
Livingston Depot Foundation Inc	/org/livingston-depot-foundation-inc
Montana Congress Of Parents Teachers Students	/org/montana-congress-of-parents-teachers-students-39
HELP COMMITTEE AND BOYS & GIRLS CLUB OF THE HI-LINE	/org/help-committee-and-boys-girls-club-of-the-hi-line
Whitefish Youth Soccer Association	/org/whitefish-youth-soccer-association
Calvary Chapel Of The Flathead Valley	/org/calvary-chapel-of-the-flathead-valley
Missoula Food Bank Inc	/org/missoula-food-bank-inc
Montana Congress Of Parents Teachers Students	/org/montana-congress-of-parents-teachers-students_66593
Job Connection Inc	/org/job-connection-inc
Pondera Food Pantry Inc	/org/pondera-food-pantry-inc
Church Of The Open Bible	/org/church-of-the-open-bible-7
Stillwater Historical Society	/org/stillwater-historical-society
Parent Teachers Houseparent Association	/org/parent-teachers-houseparent-association
Montana Congress Of Parents Teachers Students	/org/montana-congress-of-parents-teachers-students_66600
Mental Health Association Of Montana Incorporated	/org/mental-health-association-of-montana-incorporated
Bozeman Film Festival Inc	/org/bozeman-film-festival-inc
Missoula Community Health Services Inc	/org/missoula-community-health-services-inc
Beaverhead Allied Senior Services	/org/beaverhead-allied-senior-services
Animal Welfare League Of Montana	/org/animal-welfare-league-of-montana
Montana Congress Of Parents Teachers Students	/org/montana-congress-of-parents-teachers-students-16
River House Inc	/org/river-house-inc
Laurel Library Trust	/org/laurel-library-trust
Ronald Mcdonald House Charities Of Eastern Montana	/org/ronald-mcdonald-house-charities-of-eastern-montana
New Life Assembly	/org/new-life-assembly-16
Evangelical Free Church Of Cut Bank	/org/evangelical-free-church-of-cut-bank
Great Falls American Legion Baseball Club	/org/great-falls-american-legion-baseball-club
Scottie Day Care Inc	/org/scottie-day-care-inc
Little Brown Church Of The Christian And Missionary Alliance	/org/little-brown-church-of-the-christian-and-missionary-alliance
Stumptown Historical Society Of Flathead County Inc	/org/stumptown-historical-society-of-flathead-county-inc
Three Lakes Community Bib	/org/three-lakes-community-bib
Lutheran Bible Camp Inc	/org/lutheran-bible-camp-inc
Bigfork Christian Church	/org/bigfork-christian-church
Sun River Valley Historical Society	/org/sun-river-valley-historical-society
Lincoln County Combined Campaign	/org/lincoln-county-combined-campaign
Montana State University-Northern Foundation	/org/montana-state-university-northern-foundation
Christ Lutheran Church	/org/christ-lutheran-church-210
Montana Radio Reading Service	/org/montana-radio-reading-service
Faith Alliance Church	/org/faith-alliance-church-5
Dracut Junction/Stone Barn Co	/org/dracut-junction-stone-barn-co
Bridger Ski Foundation	/org/bridger-ski-foundation
Wheatland Memorial Healthcare	/org/wheatland-memorial-healthcare
Belmont Ski Education Foundation	/org/belmont-ski-education-foundation
Montana Higher Education Student Assistance Corporation	/org/montana-higher-education-student-assistance-corporation
Five Valley Lutheran Retirement Center	/org/five-valley-lutheran-retirement-center
Missoula Museum Of The Arts Foundation	/org/missoula-museum-of-the-arts-foundation
Church Of Christ	/org/church-of-christ-106
Miles City Foursquare Church	/org/miles-city-foursquare-church
Western Montana Area Vi Agency On Aging	/org/western-montana-area-vi-agency-on-aging
Mission Mountain Enterprises Inc	/org/mission-mountain-enterprises-inc
Thompson Falls Lions Manor Inc	/org/thompson-falls-lions-manor-inc
Livingston Meals On Wheels	/org/livingston-meals-on-wheels
Montana Economic Revitalization And Development Institute Inc	/org/montana-economic-revitalization-and-development-institute-inc
Christ Church Of The Open Door	/org/christ-church-of-the-open-door
Old Paths Strict Baptist Church Inc	/org/old-paths-strict-baptist-church-inc
Blackfeet Opportunities Inc	/org/blackfeet-opportunities-inc
Montana Art Gallery Directors Association	/org/montana-art-gallery-directors-association
Phillips County Historical Society	/org/phillips-county-historical-society
Women's Aglow Fellowship	/org/womens-aglow-fellowship_178489
St Thomas Child And Family Center	/org/st-thomas-child-and-family-center
Young Womens Christian Association	/org/young-womens-christian-association-30
Montana State University Alumni Association	/org/montana-state-university-alumni-association
Montana School Boards Association	/org/montana-school-boards-association
Yellowstone Boys & Girls Ranch	/org/yellowstone-boys-girls-ranch
United Way Of Yellowstone County Inc	/org/united-way-of-yellowstone-county-inc
Big Sandy Medical Center Inc	/org/big-sandy-medical-center-inc
Gateway Community Services	/org/gateway-community-services
Rural Dynamics Inc	/org/rural-dynamics-inc
Fairview Alliance Church Inc Of The Christian And Missionary Alliance	/org/fairview-alliance-church-inc-of-the-christian-and-missionary-alliance
Headwaters Resource Conservation And Development Area Inc	/org/headwaters-resource-conservation-and-development-area-inc
HEART OF THE VALLEY HUMANE SOCIETY INC	/org/heart-of-the-valley-humane-society-inc
Gallatin Valley Literacy Council	/org/gallatin-valley-literacy-council
Institute Of Management Accountants Inc	/org/institute-of-management-accountants-inc_100536
Powell County Museum & Arts Foundation Inc	/org/powell-county-museum-arts-foundation-inc
Gates Of The Mountain Foundation	/org/gates-of-the-mountain-foundation
Montana Dance Arts Association	/org/montana-dance-arts-association
Christian Hosptitality Center	/org/christian-hosptitality-center
Christian And Missionary Alliance Church Of Glendive	/org/christian-and-missionary-alliance-church-of-glendive
Child Care Resources Inc	/org/child-care-resources-inc-4
Soil And Water Conservation	/org/soil-and-water-conservation
Missoula County Cancer Association	/org/missoula-county-cancer-association
Northern Division Amateur Ski Educational Foundation	/org/northern-division-amateur-ski-educational-foundation
Bigfork Development Company	/org/bigfork-development-company
La Leche League International Inc	/org/la-leche-league-international-inc-53
Central Christian Church Foundation Billings Montana	/org/central-christian-church-foundation-billings-montana
Bozeman Senior Social Center Inc	/org/bozeman-senior-social-center-inc
Montana Academy Of Ophthalmology	/org/montana-academy-of-ophthalmology
Phi Upsilon Omicron Inc	/org/phi-upsilon-omicron-inc-55
International Church Of The Foursquare Gospel	/org/international-church-of-the-foursquare-gospel_115775
Rocky Mountain Foundation Inc	/org/rocky-mountain-foundation-inc
Community Youth Ministries	/org/community-youth-ministries
Meagher County Senior Citizens	/org/meagher-county-senior-citizens
Parents Without Partners, Inc.	/org/parents-without-partners-inc_121375
Montana Congress Of Parents Teachers Students	/org/montana-congress-of-parents-teachers-students_121409
Friends Of The Fairfield Library	/org/friends-of-the-fairfield-library
Secular Franciscan Order	/org/secular-franciscan-order
Aglow International	/org/aglow-international_121424
Montana Congress Of Parents Teachers Students	/org/montana-congress-of-parents-teachers-students_121439
Kay Mckenna Youth Foundation	/org/kay-mckenna-youth-foundation
Montana Rural Development Partners	/org/montana-rural-development-partners
Eh Namani	/org/eh-namani
Missions To America Incorporated	/org/missions-to-america-incorporated
Arrow And Spike Association, Inc.	/org/arrow-and-spike-association-inc
Mikal Kellner Foundation For Animals Trust Dba The Foundation For Animals	/org/mikal-kellner-foundation-for-animals-trust-dba-the-foundation-for-animals
Marguerite L Overland Charitable Trust	/org/marguerite-l-overland-charitable-trust
Clarence L Moyle Trust Fbo Spokane Shriners Hospital For Crippled	/org/clarence-l-moyle-trust-fbo-spokane-shriners-hospital-for-crippled
Soldiers Chapel Corporation	/org/soldiers-chapel-corporation
Grace Bible Church	/org/grace-bible-church-69
National Huguenot Society	/org/national-huguenot-society_122420
International Training In Communication	/org/international-training-in-communication_122421
Rocky Mountain Assn For Retarded Children	/org/rocky-mountain-assn-for-retarded-children
Psi Chi The National Honor Society In Psychology	/org/psi-chi-the-national-honor-society-in-psychology-932
Great Falls Rescue Mission	/org/great-falls-rescue-mission
Yellowstone Art Museum	/org/yellowstone-art-museum
Red Lodge Music Festival	/org/red-lodge-music-festival
Polson-Flathead Historical Museum Inc	/org/polson-flathead-historical-museum-inc
Gloria Dei Lutheran Church	/org/gloria-dei-lutheran-church-29
