org_name	org_url
Mata Amritanandamayi Math	/org/mata-amritanandamayi-math
Defensa Animal De Rincon	/org/defensa-animal-de-rincon
Amigos De Los Animales Inc	/org/amigos-de-los-animales-inc
Humane Society Of Puerto Rico Inc	/org/humane-society-of-puerto-rico-inc
Advanced Bilingual School Inc	/org/advanced-bilingual-school-inc
Estancia Corazon Inc	/org/estancia-corazon-inc
Save A Gato Inc	/org/save-a-gato-inc
Programa De Educacion Comunal De Entrega Y Servicio Inc	/org/programa-de-educacion-comunal-de-entrega-y-servicio-inc
Juan Domingo En Accion Inc	/org/juan-domingo-en-accion-inc
VolNepal	/org/volnepal
Asesores Financieros Comunitarios Inc	/org/asesores-financieros-comunitarios-inc
UNIDOS POR LOS ANIMALES, INC.	/org/unidos-por-los-animales-inc
Time Community Business And Development Corporation	/org/time-community-business-and-development-corporation
Corporacion De Puerto Rico Para La Difusion Publica	/org/corporacion-de-puerto-rico-para-la-difusion-publica
Abc Infantil Inc	/org/abc-infantil-inc
Prensa Comunitaria Inc	/org/prensa-comunitaria-inc
Taller Salud Inc	/org/taller-salud-inc
Puerto Rico Conservation Trust	/org/puerto-rico-conservation-trust
HOPE FOUNDATION TRUST NEPAL	/org/hope-foundation-trust-nepal
Fundacion Save A Sato Inc	/org/fundacion-save-a-sato-inc
Make A Difference Foundation Pr Inc	/org/make-a-difference-foundation-pr-inc
Friends Of Culebra Animals Inc	/org/friends-of-culebra-animals-inc
Caribbean University	/org/caribbean-university
Pare Este Inc	/org/pare-este-inc
Maranatha Civil Emergency Life Support Group & Communication Inc	/org/maranatha-civil-emergency-life-support-group-communication-inc
Iglesia Carismatica Cristiana	/org/iglesia-carismatica-cristiana
Remanso De Esperanza Inc	/org/remanso-de-esperanza-inc
Civil Air Patrol	/org/civil-air-patrol_118822
Camuy Health Services Inc	/org/camuy-health-services-inc_56251
Iglesia Carismatica De Corozal Inc	/org/iglesia-carismatica-de-corozal-inc
Misioneras Del Santisimo Sacramento Y Maria Immaculada	/org/misioneras-del-santisimo-sacramento-y-maria-immaculada
Civil Air Patrol	/org/civil-air-patrol_16388
Colegio Radians Inc	/org/colegio-radians-inc
Civil Air Patrol	/org/civil-air-patrol_43539
Camuy Health Services Inc	/org/camuy-health-services-inc
Primera Inglesia Del Nazareno	/org/primera-inglesia-del-nazareno
Instituto De Education Universal, Inc.	/org/instituto-de-education-universal-inc
Pro Arte Musical Inc	/org/pro-arte-musical-inc
Colegio Nuestra Sra Del Rosario Hato Tejas	/org/colegio-nuestra-sra-del-rosario-hato-tejas
Civil Air Patrol 52000 Pr Wing Support	/org/civil-air-patrol-52000-pr-wing-support
Civil Air Patrol	/org/civil-air-patrol_99720
Civil Air Patrol	/org/civil-air-patrol_99721
Institute Of Industrial Engineers Inc	/org/institute-of-industrial-engineers-inc_102275
Civil Air Patrol	/org/civil-air-patrol_118821
Civil Air Patrol	/org/civil-air-patrol_211674
United States Power Squadrons	/org/united-states-power-squadrons-27
Casa De La Bondad Inc	/org/casa-de-la-bondad-inc
Civil Air Patrol	/org/civil-air-patrol_128991
Industria Y Comercio Pro Reciclaje Inc	/org/industria-y-comercio-pro-reciclaje-inc
Museo De Arte De Puerto Rico Inc	/org/museo-de-arte-de-puerto-rico-inc
React International	/org/react-international_129003
Fundacion Rene Aponte Inc	/org/fundacion-rene-aponte-inc
The Vieques Conservation And Historical Trust Inc	/org/the-vieques-conservation-and-historical-trust-inc
Puerto Rico Legal Services Incorporated	/org/puerto-rico-legal-services-incorporated
Salud Integral En La Montana Inc	/org/salud-integral-en-la-montana-inc
Sociedad Pro Hospital Del Nino	/org/sociedad-pro-hospital-del-nino
Vieques Humane Society & Animal Rescue Inc	/org/vieques-humane-society-animal-rescue-inc
Caribean Synod Of The Evangelical Lutheran Church In America	/org/caribean-synod-of-the-evangelical-lutheran-church-in-america
Institute Of Management Accountants Inc	/org/institute-of-management-accountants-inc_16404
Pr Summit Coordinating Committee, Inc.	/org/pr-summit-coordinating-committee-inc
Mabodamaca Corporacion Pro-Rescate Ermita San Antonio De La Tuna	/org/mabodamaca-corporacion-pro-rescate-ermita-san-antonio-de-la-tuna
Ceiba Housing And Economic Development Corporation	/org/ceiba-housing-and-economic-development-corporation
Sociedad Espanola De Auxilio Mutuo Y Beneficencia De Puerto Rico	/org/sociedad-espanola-de-auxilio-mutuo-y-beneficencia-de-puerto-rico
Teatro Del 60 Inc	/org/teatro-del-60-inc
Comite Olimpico De Puerto Rico Inc Old Naval Base San Juan	/org/comite-olimpico-de-puerto-rico-inc-old-naval-base-san-juan
Reform Jewish Congregation Of Puerto Rico Inc	/org/reform-jewish-congregation-of-puerto-rico-inc
Asociacion Pro Juventud Y Comunidad De Barrio Palmas Inc	/org/asociacion-pro-juventud-y-comunidad-de-barrio-palmas-inc
Puerto Rico Community Foundation Inc	/org/puerto-rico-community-foundation-inc
Asociacion Pro Albergue De Animales Inc	/org/asociacion-pro-albergue-de-animales-inc
Iglesia Cristiana Carismatica De Levittown Inc	/org/iglesia-cristiana-carismatica-de-levittown-inc
Museo De Arte Contemporaneo De Puerto Rico Inc	/org/museo-de-arte-contemporaneo-de-puerto-rico-inc
Iglesia Carismatica De Ponce Inc	/org/iglesia-carismatica-de-ponce-inc
Caribe Girl Scouts Council Inc	/org/caribe-girl-scouts-council-inc
Instituto Del Hogar Celia Y Harris Bunker Inc	/org/instituto-del-hogar-celia-y-harris-bunker-inc
Fundacion De Desarrollo Comunal De P R Inc	/org/fundacion-de-desarrollo-comunal-de-p-r-inc
Civil Air Patrol	/org/civil-air-patrol_155541
Padmasambhava Buddhist Center Of Puerto Rico	/org/padmasambhava-buddhist-center-of-puerto-rico
Institute Of Management Accountants Inc	/org/institute-of-management-accountants-inc_160982
React International	/org/react-international_174740
March Of Dimes Birth Defects	/org/march-of-dimes-birth-defects_174942
Junta De Residentes Del Residencial La Alhambra, Inc.	/org/junta-de-residentes-del-residencial-la-alhambra-inc
Puerto Rico Community Network For Clinical Research On Aids	/org/puerto-rico-community-network-for-clinical-research-on-aids
Ann Wigmore Natural Health Institute Inc	/org/ann-wigmore-natural-health-institute-inc
Hogar De Ayuda El Refugio Inc	/org/hogar-de-ayuda-el-refugio-inc
Hospital Sin Paredes Inc	/org/hospital-sin-paredes-inc
Altergarten Las Teresas Ii Inc	/org/altergarten-las-teresas-ii-inc
Iglesia Fe Es La Victoria Inc	/org/iglesia-fe-es-la-victoria-inc
Corporacion Para Restauracion Teatro Oliver	/org/corporacion-para-restauracion-teatro-oliver
Iem Al Amparo De La Roca	/org/iem-al-amparo-de-la-roca
Centro De Servicios Primarios De Sa Lud Inc	/org/centro-de-servicios-primarios-de-sa-lud-inc
Caribbean Christian Crusade Inc	/org/caribbean-christian-crusade-inc
Southeastern Mennonite Conference Inc	/org/southeastern-mennonite-conference-inc
Future Business Leaders Of America Phi Beta Lambda Inc	/org/future-business-leaders-of-america-phi-beta-lambda-inc
Association For Computing Machinery-Interamer University Of Pr San Germain	/org/association-for-computing-machinery-interamer-university-of-pr-san-germain
Civil Air Patrol	/org/civil-air-patrol_231075
React International	/org/react-international_231112
Iglesia Carismatica Dios Con Nosotros Inc	/org/iglesia-carismatica-dios-con-nosotros-inc
Head Start Program Iglesia De Dios Pentecostal Mi Region De Puerto	/org/head-start-program-iglesia-de-dios-pentecostal-mi-region-de-puerto
Asamblea Familiar Virgilio Davila Inc	/org/asamblea-familiar-virgilio-davila-inc
Museo De Las Americas Inc	/org/museo-de-las-americas-inc
Civil Air Patrol, Inc.	/org/civil-air-patrol-inc_241232
Iglesia Cristiana Restauradores	/org/iglesia-cristiana-restauradores
Puerto Rico Manufacturing Extension Primex Inc	/org/puerto-rico-manufacturing-extension-primex-inc
Fundacion Dr John A & Virginia Smith Inc	/org/fundacion-dr-john-a-virginia-smith-inc
Producir Inc Una Corp De Desarrollo Comunal Y Econ Para Cubuy Y Lomas	/org/producir-inc-una-corp-de-desarrollo-comunal-y-econ-para-cubuy-y-lomas
Teen Challenge De Puerto Rico Inc	/org/teen-challenge-de-puerto-rico-inc
Union Church Of San Juan	/org/union-church-of-san-juan
Evangelical School For The Deaf	/org/evangelical-school-for-the-deaf
Sociedad Iglesia Missionera International	/org/sociedad-iglesia-missionera-international
Iniciativa Comunitaria De Investigacion Inc	/org/iniciativa-comunitaria-de-investigacion-inc
Esperanza Para La Vejez Inc	/org/esperanza-para-la-vejez-inc
Inter American University Of Puerto Rico	/org/inter-american-university-of-puerto-rico
Ponce Neighborhood Housing Services Inc	/org/ponce-neighborhood-housing-services-inc
Mision De Los Christianos Carismatic Una Puetra Abierta Inc	/org/mision-de-los-christianos-carismatic-una-puetra-abierta-inc
Egida Ryder Inc	/org/egida-ryder-inc
Service Corps Of Retired Executives Association	/org/service-corps-of-retired-executives-association_241252
Corporacion Para El Desarrollo De La Vivienda De Bayamon Cd	/org/corporacion-para-el-desarrollo-de-la-vivienda-de-bayamon-cd
Ymca Of San Juan	/org/ymca-of-san-juan
Saint Johns School	/org/saint-johns-school
Bella Vista Hospital Inc	/org/bella-vista-hospital-inc
Pro Viviendas Iii Inc	/org/pro-viviendas-iii-inc
Corporacion Educativa Ramon Barquin	/org/corporacion-educativa-ramon-barquin
United States Power Squadrons	/org/united-states-power-squadrons-25
Universidad Central De Bayamon Inc	/org/universidad-central-de-bayamon-inc
Boys & Girls Clubs Of Puerto Rico Inc	/org/boys-girls-clubs-of-puerto-rico-inc
Civil Air Patrol	/org/civil-air-patrol_241268
Civil Air Patrol	/org/civil-air-patrol_241269
React International	/org/react-international_241270
Caribbean Environment And Development Institute	/org/caribbean-environment-and-development-institute
Civil Air Patrol	/org/civil-air-patrol_268101
Civil Air Patrol	/org/civil-air-patrol_268102
Families Planning Association Of Puerto Rico	/org/families-planning-association-of-puerto-rico
Sociedad Economica De Amigos Del Pais Inc	/org/sociedad-economica-de-amigos-del-pais-inc
Civil Air Patrol	/org/civil-air-patrol_287403
React International	/org/react-international_287433
Rio Grande Community Health Center Inc	/org/rio-grande-community-health-center-inc
Iglesia De Dios Pentecostal M I Movimiento Internacional	/org/iglesia-de-dios-pentecostal-m-i-movimiento-internacional-1
Communion Foundation, Inc.	/org/communion-foundation-inc
General Council Of The Assemblies Of God	/org/general-council-of-the-assemblies-of-god_297517
Cossma Inc	/org/cossma-inc
Advanced Community Health Services, Inc.	/org/advanced-community-health-services-inc
Iglesia La Trompeta Final Inc	/org/iglesia-la-trompeta-final-inc
Wisconsin Evangelical Lutheran Synod Wels	/org/wisconsin-evangelical-lutheran-synod-wels
Hospital Auxilio Mutuo Inc	/org/hospital-auxilio-mutuo-inc
Iglesia Asambleas De Dios De Irlanda Heights Inc	/org/iglesia-asambleas-de-dios-de-irlanda-heights-inc
Bills Kitchen Inc	/org/bills-kitchen-inc
Civil Air Patrol	/org/civil-air-patrol_297541
International Reading Association, Inc.	/org/international-reading-association-inc-490
Iglesia Carismatica De Adjuntas Inc	/org/iglesia-carismatica-de-adjuntas-inc
Font Martello Home Care Program Inc	/org/font-martello-home-care-program-inc
Mision Evangelica Cristiana De Arecibo Inc	/org/mision-evangelica-cristiana-de-arecibo-inc
Atlantic College, Inc.	/org/atlantic-college-inc
Iglesia Carismatica Rios De Agua Viva Inc	/org/iglesia-carismatica-rios-de-agua-viva-inc
Servicios De Salud Primarios De	/org/servicios-de-salud-primarios-de
La Fondita De Jesus	/org/la-fondita-de-jesus
Casa De Ninos Manuel Fernandez Juncos Inc	/org/casa-de-ninos-manuel-fernandez-juncos-inc
Ryder Memorial Hospital Inc	/org/ryder-memorial-hospital-inc
Aspira Inc De Puerto Rico	/org/aspira-inc-de-puerto-rico
Liceo De Arte Y Tecnologia Inc	/org/liceo-de-arte-y-tecnologia-inc
Civil Air Patrol	/org/civil-air-patrol_302839
Mision Christiana Jehova-Nisi	/org/mision-christiana-jehova-nisi
Casa De Restauracion La Nueva Jerusalen	/org/casa-de-restauracion-la-nueva-jerusalen
Ryder Assisted Care Iii Inc	/org/ryder-assisted-care-iii-inc
American Institute Of Chemical Engineers	/org/american-institute-of-chemical-engineers-8
Iglesia Carismatica El Nuevo Nacimiento Inc	/org/iglesia-carismatica-el-nuevo-nacimiento-inc
Mision Christiana Eden	/org/mision-christiana-eden
Civil Air Patrol	/org/civil-air-patrol_343613
Monteclaro Inc	/org/monteclaro-inc
Centros Sor Isolina Ferre Endowment Trust	/org/centros-sor-isolina-ferre-endowment-trust
Foundation For The University Of Puerto Rico	/org/foundation-for-the-university-of-puerto-rico
Full Gospel Businessmens Fellowship International	/org/full-gospel-businessmens-fellowship-international_353928
Iglesia Carismatica Bethel Inc	/org/iglesia-carismatica-bethel-inc
Centro De Investigaciones Folkloricas De Puerto Rico Inc	/org/centro-de-investigaciones-folkloricas-de-puerto-rico-inc
Pueblo De Dios Jesus Senor Y Rey	/org/pueblo-de-dios-jesus-senor-y-rey
Iglesia El Buen Pastor Asambleas De Dios Inc	/org/iglesia-el-buen-pastor-asambleas-de-dios-inc
Asociacion Educativa Pro-Desarrollo Humano De Culebra Inc	/org/asociacion-educativa-pro-desarrollo-humano-de-culebra-inc
Corp Serv Med Prim Y Prev De Hatillo	/org/corp-serv-med-prim-y-prev-de-hatillo
Iglesia Carismatica Cristianos Renovados Inc	/org/iglesia-carismatica-cristianos-renovados-inc
Fundacion Dida De Puerto Rico In	/org/fundacion-dida-de-puerto-rico-in
Second Harvest Of Puerto Rico Inc	/org/second-harvest-of-puerto-rico-inc
Freedom Chapel	/org/freedom-chapel
Christo Victorioso	/org/christo-victorioso
Silo Mision Cristiana Inc	/org/silo-mision-cristiana-inc
Civil Air Patrol	/org/civil-air-patrol_353959
Hospital General De Castaner Inc	/org/hospital-general-de-castaner-inc
Biblioteca Jane Stern	/org/biblioteca-jane-stern
Hospital San Carlos Incorporado	/org/hospital-san-carlos-incorporado
Ponce Medical School Foundation Inc	/org/ponce-medical-school-foundation-inc
Fundacion Luis Munoz Marin Inc	/org/fundacion-luis-munoz-marin-inc
Centro Cultural Y De Servicios De Cantera Inc	/org/centro-cultural-y-de-servicios-de-cantera-inc
Comite Gericola Regional De Mayagugz Incorporado	/org/comite-gericola-regional-de-mayagugz-incorporado
Atrevete Inc	/org/atrevete-inc
FUNDACION NACIONAL PARA LA CULTURA POPULAR	/org/fundacion-nacional-para-la-cultura-popular
Ja Worldwide Inc	/org/ja-worldwide-inc-1
American Cancer Society Inc	/org/american-cancer-society-inc-5
Civil Air Patrol	/org/civil-air-patrol_359273
American Society Of Agricultural Engineers	/org/american-society-of-agricultural-engineers-2
Civil Air Patrol	/org/civil-air-patrol_380526
Civil Air Patrol	/org/civil-air-patrol_399841
Civil Air Patrol	/org/civil-air-patrol_399842
Concilio Menonita De Puerto Rico Inc	/org/concilio-menonita-de-puerto-rico-inc
Lucha Contra El Sida Inc	/org/lucha-contra-el-sida-inc
Pro Viviendas Iv Inc	/org/pro-viviendas-iv-inc
Centro De Ayuda Y Terapia Al Nino Con Impedimento Inc	/org/centro-de-ayuda-y-terapia-al-nino-con-impedimento-inc
Fundacion Puertorriquena Sindrome Down	/org/fundacion-puertorriquena-sindrome-down
Palmas Academy Inc	/org/palmas-academy-inc
Full Gospel Businessmens Fellowship International	/org/full-gospel-businessmens-fellowship-international_410216
The Jane Stern Dorado Community Library Endowment	/org/the-jane-stern-dorado-community-library-endowment
Iglesia Carismatica Pastillo Canas Inc	/org/iglesia-carismatica-pastillo-canas-inc
Liga Estudiantes De Arte De San Juan Inc P O Box 5181	/org/liga-estudiantes-de-arte-de-san-juan-inc-p-o-box-5181
Caribbean Food Bank	/org/caribbean-food-bank
Voluntarios En Accion Contra El Sida Inc	/org/voluntarios-en-accion-contra-el-sida-inc
Proyecto Sueno De Amor Sida Pediatrico Inc	/org/proyecto-sueno-de-amor-sida-pediatrico-inc
Iglesia Manantial De Vida Inc	/org/iglesia-manantial-de-vida-inc
Hpm Foundation Inc	/org/hpm-foundation-inc
Fundacion Infantil Ronald Mcdonald Inc	/org/fundacion-infantil-ronald-mcdonald-inc
La Casa Del Libro Inc	/org/la-casa-del-libro-inc
Luis A Ferre Foundation Inc	/org/luis-a-ferre-foundation-inc
St Lukes Episcopal Church Home Care Program	/org/st-lukes-episcopal-church-home-care-program
Consejo De Salud De Puerto Rico Inc	/org/consejo-de-salud-de-puerto-rico-inc
Southwestern Educational Society Inc	/org/southwestern-educational-society-inc
Strive De Puerto Rico Inc	/org/strive-de-puerto-rico-inc
General Council Of The Assemblies Of God	/org/general-council-of-the-assemblies-of-god_410248
Puerto Rican Center For Lifelong Studies	/org/puerto-rican-center-for-lifelong-studies
Ballet Concierto De Puerto Rico Inc	/org/ballet-concierto-de-puerto-rico-inc
Society Of American Military Engineers	/org/society-of-american-military-engineers_410253
Civil Air Patrol	/org/civil-air-patrol_415748
Civil Air Patrol 52154 Hatillo Camuy Cadet Squadron	/org/civil-air-patrol-52154-hatillo-camuy-cadet-squadron
Messianic Church For Divine Law And Christian Science Inc	/org/messianic-church-for-divine-law-and-christian-science-inc
Civil Air Patrol	/org/civil-air-patrol_436949
Mycological Society Of America The	/org/mycological-society-of-america-the
La Perla De Gran Precio Inc	/org/la-perla-de-gran-precio-inc
Jardin De La Infancia	/org/jardin-de-la-infancia
Mision Cristiana John 3 16 Ad	/org/mision-cristiana-john-3-16-ad
Centro Deambulantes Cristo Pobre Inc	/org/centro-deambulantes-cristo-pobre-inc
Hermanos Franciscanos De La Providencia Inc	/org/hermanos-franciscanos-de-la-providencia-inc
Iglesia Carismatica Jehova Justicia Nuestra Inc	/org/iglesia-carismatica-jehova-justicia-nuestra-inc
Primera Asamblea De Dios Barceloneta	/org/primera-asamblea-de-dios-barceloneta
Calvary Evangelistic Mission Inc	/org/calvary-evangelistic-mission-inc
Servicios Cientificos Y Tecnicos Inc	/org/servicios-cientificos-y-tecnicos-inc
Cuarzo Blanco Inc	/org/cuarzo-blanco-inc
Iglesia Asambleas De Dios Siloe	/org/iglesia-asambleas-de-dios-siloe
Escuela De Artes Plasticas Y Diseno De Puerto Rico	/org/escuela-de-artes-plasticas-y-diseno-de-puerto-rico
Centro De Servicios Ferran Inc	/org/centro-de-servicios-ferran-inc
Neomed Center Inc	/org/neomed-center-inc
Educational Center For The Blind And The Handicapped Of Puerto Rico	/org/educational-center-for-the-blind-and-the-handicapped-of-puerto-rico
Coro De Ninos De San Juan	/org/coro-de-ninos-de-san-juan
Casa Candina, Inc.	/org/casa-candina-inc
Centro De Estudios Avanzados De Puerto Rico Inc	/org/centro-de-estudios-avanzados-de-puerto-rico-inc
Accion Social De Puerto Rico Inc	/org/accion-social-de-puerto-rico-inc
Instituto Prevocacional E Industrial De Puerto Rico	/org/instituto-prevocacional-e-industrial-de-puerto-rico
Costa Salud Community Health Centers Inc	/org/costa-salud-community-health-centers-inc
Teatro De La Comedia Inc	/org/teatro-de-la-comedia-inc
Universal Technology College Of Pr Inc	/org/universal-technology-college-of-pr-inc
Carlos Albizu University	/org/carlos-albizu-university
Colegio Evangelico Capitan Correa Inc	/org/colegio-evangelico-capitan-correa-inc
Centros Sor Isolina Ferre Inc	/org/centros-sor-isolina-ferre-inc
Asociacion De Intercambio Cultural Inc	/org/asociacion-de-intercambio-cultural-inc
Civil Air Patrol	/org/civil-air-patrol_471774
Primera Iem De Arecibo	/org/primera-iem-de-arecibo
Civil Air Patrol	/org/civil-air-patrol_493458
Israel Rodriguez Evangelistic Association Inc	/org/israel-rodriguez-evangelistic-association-inc
Iglesia Pueblo De Dios Pentecostal	/org/iglesia-pueblo-de-dios-pentecostal
University Of Puerto Rico School Of Law Trust	/org/university-of-puerto-rico-school-of-law-trust
Alianza Municipal De Servicios	/org/alianza-municipal-de-servicios
Proyecto Oasis De Amor Inc	/org/proyecto-oasis-de-amor-inc
Fundacion Biblioteca Rafael Hernandez Colon Inc	/org/fundacion-biblioteca-rafael-hernandez-colon-inc
Fundacion Facultad De Derecho Eugenio Maria De Hostos	/org/fundacion-facultad-de-derecho-eugenio-maria-de-hostos
Dewey University Inc	/org/dewey-university-inc
Ciudadanos Del Karso Inc	/org/ciudadanos-del-karso-inc
Fundacion De Becas Para Estudios De Hosteleria & Turismo Inc	/org/fundacion-de-becas-para-estudios-de-hosteleria-turismo-inc
Pro Viviendas Ii Inc	/org/pro-viviendas-ii-inc
Iglesia Cahismatica Cristiana Monte Santo De Sion Inc	/org/iglesia-cahismatica-cristiana-monte-santo-de-sion-inc
Centro De Diagnostico Para Inteligencias Multiples Inc	/org/centro-de-diagnostico-para-inteligencias-multiples-inc
Programa Head Start Council For Preschool Children Of P R Inc	/org/programa-head-start-council-for-preschool-children-of-p-r-inc
Comision Pro-Sede Olimpiadas 2004 Inc	/org/comision-pro-sede-olimpiadas-2004-inc
Academia Maranatha Inc	/org/academia-maranatha-inc
Iglesia Carismatica Liberados Por Cristo Inc	/org/iglesia-carismatica-liberados-por-cristo-inc
Iglesia Cristiana El Sendero De La Cruz Inc	/org/iglesia-cristiana-el-sendero-de-la-cruz-inc
Oficina Pro Ayuda A Personas Con Impedimentos Inc	/org/oficina-pro-ayuda-a-personas-con-impedimentos-inc
Ymca Of Ponce	/org/ymca-of-ponce
Wesleyan Academy	/org/wesleyan-academy
United States Power Squadrons	/org/united-states-power-squadrons-26
Servicios De Salud En El Hogar El Nazareno Inc Box 594	/org/servicios-de-salud-en-el-hogar-el-nazareno-inc-box-594
Civil Air Patrol	/org/civil-air-patrol_549529
Sigma Theta Tau International Inc Epsilon Lambda Chapter 129	/org/sigma-theta-tau-international-inc-epsilon-lambda-chapter-129
Centro Pediatrico De Lactancia	/org/centro-pediatrico-de-lactancia
Ryder Village Inc	/org/ryder-village-inc
Housing Development C O R P Toa Baja C D	/org/housing-development-c-o-r-p-toa-baja-c-d
Youth Experiencing Success Inc	/org/youth-experiencing-success-inc
Centro De Salud De Lares Inc	/org/centro-de-salud-de-lares-inc
Centro De Servicios Primarios De	/org/centro-de-servicios-primarios-de
Fajardo Integral Community Development Corporation	/org/fajardo-integral-community-development-corporation
Church Of Scientology Of Puerto Rico	/org/church-of-scientology-of-puerto-rico
Fundacion Pro-Ninos Impedidos De Oriente Inc	/org/fundacion-pro-ninos-impedidos-de-oriente-inc
Asociacion Cristiana Ministerial Eben-Ezer Inc	/org/asociacion-cristiana-ministerial-eben-ezer-inc
Hermanos Carmelitas Teresas De San Jose Inc	/org/hermanos-carmelitas-teresas-de-san-jose-inc
Civil Air Patrol	/org/civil-air-patrol_579000
Puerto Rico Deaf Missions	/org/puerto-rico-deaf-missions
Sistema Universitario Ana G Mendez	/org/sistema-universitario-ana-g-mendez
Mennonite General Hospital Inc	/org/mennonite-general-hospital-inc
Jewish Community Center Of Puerto Rico	/org/jewish-community-center-of-puerto-rico
Rose Of Sharon Foundation Inc	/org/rose-of-sharon-foundation-inc
Fondos Unidos De Puerto Rico Inc	/org/fondos-unidos-de-puerto-rico-inc
Universidad Politecnica De Puerto Rico Inc	/org/universidad-politecnica-de-puerto-rico-inc
Phi Theta Kappa Society	/org/phi-theta-kappa-society_583574
Hispanic Educational Technology Services Inc	/org/hispanic-educational-technology-services-inc
Civil Air Patrol	/org/civil-air-patrol_605575
American Chemical Society	/org/american-chemical-society_619224
National Image Inc	/org/national-image-inc_623654
Ryder Assisted Care Inc	/org/ryder-assisted-care-inc
Puerto Rico Neighborhood Housing Services Corp	/org/puerto-rico-neighborhood-housing-services-corp
Fundacion Especial De Recursos Pro Ninos Con Inpedimentos	/org/fundacion-especial-de-recursos-pro-ninos-con-inpedimentos
Civil Air Patrol	/org/civil-air-patrol_635260
Civil Air Patrol	/org/civil-air-patrol_635262
Iglesia Cristiana Carismatica De Caguana Inc	/org/iglesia-cristiana-carismatica-de-caguana-inc
Consejo Vecinal Pro-Desarrollo De Cantera Inc	/org/consejo-vecinal-pro-desarrollo-de-cantera-inc
Colegio Santisima Trinidad Inc	/org/colegio-santisima-trinidad-inc
General Council Of The Assemblies Of God	/org/general-council-of-the-assemblies-of-god-4
Centro De Educacion Integral Soles Del Jardin Inc	/org/centro-de-educacion-integral-soles-del-jardin-inc
Ryder Health Plan Inc	/org/ryder-health-plan-inc
Lutheran Social Services Of Puerto Rico	/org/lutheran-social-services-of-puerto-rico
Migrant Health Center	/org/migrant-health-center
Hogar Infantil Jesus Nazareno Inc	/org/hogar-infantil-jesus-nazareno-inc
Fundacion Dar Inc	/org/fundacion-dar-inc
Iglesia Carismatica El Camino Inc	/org/iglesia-carismatica-el-camino-inc
Coai Inc	/org/coai-inc
Iglesia Carismatica Jesucristo El Salvador Inc	/org/iglesia-carismatica-jesucristo-el-salvador-inc
Pontifical Catholic University Of Puerto Rico	/org/pontifical-catholic-university-of-puerto-rico
Oblatas Del Santisimo Redentor Inc Bo Cerro Gordo Bayamon Pr 00619	/org/oblatas-del-santisimo-redentor-inc-bo-cerro-gordo-bayamon-pr-00619
Sociedad Biblica De Puerto Rico E Islas Virgenes Inc	/org/sociedad-biblica-de-puerto-rico-e-islas-virgenes-inc
Universidad Central Del Caribe Inc	/org/universidad-central-del-caribe-inc
Civil Air Patrol	/org/civil-air-patrol_635299
Asociacion Fomento Educativo Inc	/org/asociacion-fomento-educativo-inc
Dorado Community Church	/org/dorado-community-church
Colegio Univeristario Bautista De Puerto Rico	/org/colegio-univeristario-bautista-de-puerto-rico
Oficina Legal De La Comunidad Inc	/org/oficina-legal-de-la-comunidad-inc
Civil Air Patrol	/org/civil-air-patrol_640533
Iglesia Evangelica Misionera Distrito De Puerto Rico	/org/iglesia-evangelica-misionera-distrito-de-puerto-rico
Kappa Omicron Nu Inc	/org/kappa-omicron-nu-inc_660364
Civil Air Patrol	/org/civil-air-patrol_661937
American Red Cross-Puerto Rico Chapter	/org/american-red-cross-puerto-rico-chapter
Corporacion De Apoyo A Programas Educativos Y Comunitarios	/org/corporacion-de-apoyo-a-programas-educativos-y-comunitarios
Full Gospel Businessmens Fellowship International	/org/full-gospel-businessmens-fellowship-international_683446
Habitat For Humanity International	/org/habitat-for-humanity-international-12
Iglesia Episcopal Puertorriquena Inc	/org/iglesia-episcopal-puertorriquena-inc
Iglesia Pentecostal Vida Y Verdad De Las Asambleas De Dios	/org/iglesia-pentecostal-vida-y-verdad-de-las-asambleas-de-dios
Padres Escolapios De P R Inc	/org/padres-escolapios-de-p-r-inc
Andanza Inc	/org/andanza-inc
Casa Joven Del Caribe Inc	/org/casa-joven-del-caribe-inc
Ciudad Mistica Inc	/org/ciudad-mistica-inc
Iglesia De Pentecostal De Renovacion Christiana Inc	/org/iglesia-de-pentecostal-de-renovacion-christiana-inc
Iniciativa Comunitaria De Arecibo Ica Inc	/org/iniciativa-comunitaria-de-arecibo-ica-inc
Fundacion Modesto Gotay Pro Ninos Mentalmente Impedidos Inc	/org/fundacion-modesto-gotay-pro-ninos-mentalmente-impedidos-inc
Iglesia Bautista Bethel De P R	/org/iglesia-bautista-bethel-de-p-r
Madrinas Y Padrinos De Cidra Inc	/org/madrinas-y-padrinos-de-cidra-inc
Academia De Directores Medicos De Puerto Rico	/org/academia-de-directores-medicos-de-puerto-rico
Hogar Cuna De San Cristobal Inc	/org/hogar-cuna-de-san-cristobal-inc
Integral De Loiza Conciliode Salud	/org/integral-de-loiza-conciliode-salud
Centro Cristiano Fruto De La Vid	/org/centro-cristiano-fruto-de-la-vid
Iglesia Evan Mis Fe Y Obra	/org/iglesia-evan-mis-fe-y-obra
Iglesia Evangelica Misionera De Dios	/org/iglesia-evangelica-misionera-de-dios
Civil Air Patrol	/org/civil-air-patrol_741982
Puerto Rico Cancer And Health Foundation Inc	/org/puerto-rico-cancer-and-health-foundation-inc
Paralyzed Veterans Of America Puerto Rico Chapter	/org/paralyzed-veterans-of-america-puerto-rico-chapter
American College Of Puerto Rico Inc	/org/american-college-of-puerto-rico-inc
Asociacion De Salud Primaria De Puerto Rico Inc	/org/asociacion-de-salud-primaria-de-puerto-rico-inc
Puerto Rico Deaf Ministries Inc	/org/puerto-rico-deaf-ministries-inc
Spina Bifida & Hidrocephalus Association Of Puerto Rico Inc	/org/spina-bifida-hidrocephalus-association-of-puerto-rico-inc
La Casa De Todos	/org/la-casa-de-todos
Asociacion Puerto Rico Quena De Diabetes	/org/asociacion-puerto-rico-quena-de-diabetes
Hogar Albergue De Ninos Maltratados De San German Inc	/org/hogar-albergue-de-ninos-maltratados-de-san-german-inc
Morovis Community Health Center Inc	/org/morovis-community-health-center-inc
Puerto Rico Youth At Risk Inc	/org/puerto-rico-youth-at-risk-inc
Comite Caborrojenos Pro Salud Y Ambiente Inc	/org/comite-caborrojenos-pro-salud-y-ambiente-inc
Programa De Apoyo Y Enlace Comunitario	/org/programa-de-apoyo-y-enlace-comunitario
Proyecto Aurora Inc	/org/proyecto-aurora-inc
Asistencia Legal Y Contributiva De Puerto Rico Inc	/org/asistencia-legal-y-contributiva-de-puerto-rico-inc
Casa Del Peregrino	/org/casa-del-peregrino
Coordinadora Paz Para La Mujer Inc	/org/coordinadora-paz-para-la-mujer-inc
Centro De Ensenanza Para La Familia Inc	/org/centro-de-ensenanza-para-la-familia-inc
Centro De Servicios Comunitarios Vida Plena	/org/centro-de-servicios-comunitarios-vida-plena
Chabad Lubavitch Of Puerto Rico Inc	/org/chabad-lubavitch-of-puerto-rico-inc
Center For The New Economy Inc	/org/center-for-the-new-economy-inc
Calvary Chapel Of Puerto Rico Inc	/org/calvary-chapel-of-puerto-rico-inc
El Programa De Enlace Y Servicio Comunitario De Aguadilla Inc	/org/el-programa-de-enlace-y-servicio-comunitario-de-aguadilla-inc
Iglesia Misionera Shalom Y Charis	/org/iglesia-misionera-shalom-y-charis
Iglesia Evangelica Luterana Cristo El Senor	/org/iglesia-evangelica-luterana-cristo-el-senor
Casa Juan Bosco Inc	/org/casa-juan-bosco-inc
Compania De Vivienda Para Ancianos	/org/compania-de-vivienda-para-ancianos
Corporacion Desarrolladora De Viviendas Bdas Israel-Bitumul Inc	/org/corporacion-desarrolladora-de-viviendas-bdas-israel-bitumul-inc
Hospital De La Concepcion Inc	/org/hospital-de-la-concepcion-inc
Centro De Adultos Y Ninos Con Impedimentos Inc	/org/centro-de-adultos-y-ninos-con-impedimentos-inc
Casa Protegida Julia De	/org/casa-protegida-julia-de
Brisas De Ceiba Corp	/org/brisas-de-ceiba-corp
Centro Margarita Inc	/org/centro-margarita-inc
Hogar Aurora Inc	/org/hogar-aurora-inc
Hogar De Ninos El Ave Maria	/org/hogar-de-ninos-el-ave-maria
La Egida Del Nino Inc	/org/la-egida-del-nino-inc
San Jorge Childrens Foundation Inc	/org/san-jorge-childrens-foundation-inc
Baldwin School Of Puerto Rico Inc	/org/baldwin-school-of-puerto-rico-inc
Musication De Puerto Rico Inc	/org/musication-de-puerto-rico-inc
