org_name	org_url
Fellow Mortals, Inc.	/org/fellow-mortals-inc
Brew City Bully Club, Inc	/org/brew-city-bully-club-inc
Starfish Foundation Inc	/org/starfish-foundation-inc-1
Snappin Ministries Inc	/org/snappin-ministries-inc
Freedom From Religion, Inc.	/org/freedom-from-religion-inc
Wisconsin Nicaragua Partners of the Americas, Inc.	/org/wisconsin-nicaragua-partners-of-the-americas-inc
Variety - The Children's Charity of Wisconsin	/org/variety-the-childrens-charity-of-wisconsin
Vets Journey Home USA, Inc.	/org/vets-journey-home-usa-inc
International Children's Fund	/org/international-childrens-fund
Musical Pathways Foundation Inc	/org/musical-pathways-foundation-inc
Conserve School	/org/conserve-school
Innovative Schools Network	/org/innovative-schools-network
The Time Is Now to Help	/org/the-time-is-now-to-help
APS Foundation of America, Inc.	/org/aps-foundation-of-america-inc
Ceiba Foundation for Tropical Conservation, Inc.	/org/ceiba-foundation-for-tropical-conservation-inc
Washington County Humane Society Inc	/org/washington-county-humane-society-inc
Literacy Green Bay Inc	/org/literacy-green-bay-inc
Nature's Edge Therapy Center, Inc.	/org/natures-edge-therapy-center-inc
Congo Initiative	/org/congo-initiative
African American Mutual Assistance Network Inc	/org/african-american-mutual-assistance-network-inc
Wisconsin Leadership Seminars Inc	/org/wisconsin-leadership-seminars-inc
Freedom House Ministries, Inc.	/org/freedom-house-ministries-inc-2
Milwaukee Community Sailing Center Inc	/org/milwaukee-community-sailing-center-inc
Families Empowered and Supporting Treatment of Eating Disorders	/org/families-empowered-and-supporting-treatment-of-eating-disorders
Being There Reaching Out Inc	/org/being-there-reaching-out-inc
Thrasher Opera House Corporation	/org/thrasher-opera-house-corporation
No Stomach For Cancer, Inc.	/org/no-stomach-for-cancer-inc
Childrens Museum of La Crosse Inc	/org/childrens-museum-of-la-crosse-inc
Movin' Out, Inc.	/org/movin-out-inc
Independence First, Inc.	/org/independence-first-inc
MidWest SSTRC, Inc	/org/midwest-sstrc-inc
Rawhide Inc	/org/rawhide-inc
Friends of Hunt Hill Audubon Sanctuary Inc	/org/friends-of-hunt-hill-audubon-sanctuary-inc
Easter Seals Southeast Wisconsin	/org/easter-seals-southeast-wisconsin
Birch Creek Music Performance Center, Inc.	/org/birch-creek-music-performance-center-inc
Middleton Outreach Ministry, Inc.	/org/middleton-outreach-ministry-inc
Midwest Horse Welfare Foundation Inc	/org/midwest-horse-welfare-foundation-inc
Eagle River Historical Society Inc	/org/eagle-river-historical-society-inc
New Beginnings Are Possible Inc	/org/new-beginnings-are-possible-inc
Cocker Spaniel Resources Inc	/org/cocker-spaniel-resources-inc
Working Capital for Community Needs, Inc.	/org/working-capital-for-community-needs-inc
Health Ministries for Haiti Inc	/org/health-ministries-for-haiti-inc
Wild Ones -- Natural Landscapers Ltd	/org/wild-ones-natural-landscapers-ltd
LIV1440 Inc	/org/liv1440-inc
Free to Breathe	/org/free-to-breathe
CASA (Court Appointed Special Advocates) of Brown County	/org/casa-court-appointed-special-advocates-of-brown-county
Domestic Abuse Intervention Services	/org/domestic-abuse-intervention-services
Lost Creek Ranch Camp Confidence	/org/lost-creek-ranch-camp-confidence
The Green Bay TEA Party aka Wisconsin TEA Party	/org/the-green-bay-tea-party-aka-wisconsin-tea-party
ABCD: After Breast Cancer Diagnosis	/org/abcd-after-breast-cancer-diagnosis
St. Joan Antida High School	/org/st-joan-antida-high-school
Wisconsin Bleeding Disorders Network, Inc.	/org/wisconsin-bleeding-disorders-network-inc
Bay Area Humane Society	/org/bay-area-humane-society
Martell's Landing Education Center	/org/martells-landing-education-center
Above the Clouds	/org/above-the-clouds
Adopt Me Animal Rescue	/org/adopt-me-animal-rescue
Als Worldwide	/org/als-worldwide
Valley Of The Kings Sanctuary And Retreat	/org/valley-of-the-kings-sanctuary-and-retreat
Eagles Nest Center Inc	/org/eagles-nest-center-inc
Childrens Hospital Of Wisconsin Inc	/org/childrens-hospital-of-wisconsin-inc
St Ann Center for Intergenerational Care, Inc	/org/st-ann-center-for-intergenerational-care-inc
Center for Resilient Cities	/org/center-for-resilient-cities
Sharon Lynne Wilson Center for the Arts	/org/sharon-lynne-wilson-center-for-the-arts
Einstein Project, Inc.	/org/einstein-project-inc
The Becky Werner Meningitis Foundation	/org/the-becky-werner-meningitis-foundation
Linda and Gene Farley Center for Peace Justice and Sustainability I	/org/linda-and-gene-farley-center-for-peace-justice-and-sustainability-i
Catholic Charities	/org/catholic-charities-1
ArtWorks for Milwaukee	/org/artworks-for-milwaukee
Hopes Journey Retreat Inc	/org/hopes-journey-retreat-inc
Wisconsin Microfinance	/org/wisconsin-microfinance
Orphan Animal Rescue and Sanctuary, Inc.	/org/orphan-animal-rescue-and-sanctuary-inc
Food Allergy Association Of Wisconsin Inc	/org/food-allergy-association-of-wisconsin-inc
Soar of Racine Inc	/org/soar-of-racine-inc
Good Action Foundation Inc	/org/good-action-foundation-inc
Blue Stars Performing Arts For Youth Inc	/org/blue-stars-performing-arts-for-youth-inc
Ways To Work	/org/ways-to-work
Endometriosis Association, Inc.	/org/endometriosis-association-inc
Oshkosh Area Humane Society Inc	/org/oshkosh-area-humane-society-inc
Pennies-4-Paws Inc	/org/pennies-4-paws-inc
Sharon S Richardson Community Hospice Inc	/org/sharon-s-richardson-community-hospice-inc
Milwaukee Homeless Veterans Initiative	/org/milwaukee-homeless-veterans-initiative
Kids From Wisconsin Ltd.	/org/kids-from-wisconsin-ltd
Box of Balloons	/org/box-of-balloons
The Order Of The Christ Sophia Inc	/org/the-order-of-the-christ-sophia-inc
Urban Ecology Center Inc	/org/urban-ecology-center-inc
Geneva National Foundation Inc	/org/geneva-national-foundation-inc
Northwoods Wildlife Center	/org/northwoods-wildlife-center
Lifeline Italian Greyhound Rescue Inc	/org/lifeline-italian-greyhound-rescue-inc
Super Moms with Sickle Cell Inc.	/org/super-moms-with-sickle-cell-inc
Prairie Biotic Research Inc	/org/prairie-biotic-research-inc
St Croix Falls Festival Theatre	/org/st-croix-falls-festival-theatre
OccuPaws Guide Dog Association	/org/occupaws-guide-dog-association-2
The Teachers' Closet Inc.	/org/the-teachers-closet-inc
St Croix Valley Restorative Justice Program, Inc.	/org/st-croix-valley-restorative-justice-program-inc
Independent Living, Inc.	/org/independent-living-inc-1
ADASDF (Active Dogs Academy Service Dog Foundation)	/org/adasdf-active-dogs-academy-service-dog-foundation
Cream City Association Foundation Inc	/org/cream-city-foundation-inc
WWW NEXT CC INC	/org/www-next-cc-inc
HeartLove Place	/org/heartlove-place
Disability Rights Wisconsin	/org/disability-rights-wisconsin
Orc Industries Inc	/org/orc-industries-inc
Valley Cats Inc	/org/valley-cats-inc-1
Milwaukee Achiever Literacy Services Inc	/org/milwaukee-achiever-literacy-services-inc
Amazing Grace Equine Sanctuary Inc	/org/amazing-grace-equine-sanctuary-inc-1
Pueblo A Pueblo	/org/pueblo-a-pueblo
United Cerebral Palsy of Greater Dane County, Inc.	/org/united-cerebral-palsy-of-greater-dane-county-inc
Ozaukee Family Services	/org/ozaukee-family-services
Helping Paws Pet Rescue Inc	/org/helping-paws-pet-rescue-inc
Literacy Network	/org/literacy-network-1
Youth Voice Initiative Inc	/org/youth-voice-initiative-inc
Woodland Pattern Book Center	/org/woodland-pattern-book-center
Autism Society of Southeastern Wisconsin Inc	/org/autism-society-of-southeastern-wisconsin-inc
Stillwaters Cancer Support Services	/org/stillwaters-cancer-support-services
Wisconsin Council of the Blind & Visually Impaired Inc	/org/wisconsin-council-of-the-blind-visually-impaired-inc
Happily Ever After Animal Sanctuaryinc	/org/happily-ever-after-animal-sanctuaryinc
Rock River Cancer Research Foundation Inc	/org/rock-river-cancer-research-foundation-inc
Non-Toxic Youth Alternatives Inc	/org/non-toxic-youth-alternatives-inc-1
Echo Valley Hope Inc	/org/echo-valley-hope-inc
Benedict Center Inc	/org/benedict-center-inc
St Paul Elder Services Inc	/org/st-paul-elder-services-inc
Walbridge School	/org/walbridge-school
Nice Foundation Inc	/org/nice-foundation-inc
Lindsays Voice Inc.	/org/lindsays-voice-inc
Chix4acause Ltd	/org/chix4acause-ltd
Arc-Winnebago County Disability Association Inc	/org/arc-winnebago-county-disability-association-inc
Sunbear Squad Inc	/org/sunbear-squad-inc
Golden Retriever Rescue Of Wisconsin	/org/golden-retriever-rescue-of-wisconsin
3RNet - NATIONAL RURAL RECRUITMENT & RETENTION NETWORK INC	/org/3rnet-national-rural-recruitment-retention-network-inc
Just A Little Faith Foundation Inc	/org/just-a-little-faith-foundation-inc
Pewaukee Area Arts Council	/org/pewaukee-area-arts-council
St Croix Valley Foundation	/org/st-croix-valley-foundation
Veterans Assistance Foundation Inc	/org/veterans-assistance-foundation-inc-1
Bethesda Lutheran Communities	/org/bethesda-lutheran-communities
Kentons Place Breast Milk Bank and Education Center	/org/kentons-place-breast-milk-bank-and-education-center
Clean Lakes Alliance Inc	/org/clean-lakes-alliance-inc
YWCA Rock County	/org/ywca-rock-county
Canopy Center Inc	/org/canopy-center-inc
Redline Milwaukee Inc	/org/redline-milwaukee-inc
HEBRON HOUSE OF HOSPITALITY INC	/org/hebron-house-of-hospitality-inc
Milwaukee Lesbian-Gay-Bisexual-	/org/milwaukee-lesbian-gay-bisexual
First Friends Animal Rescue Inc	/org/first-friends-animal-rescue-inc
Wisconsin Ovarian Cancer Alliance Inc	/org/wisconsin-ovarian-cancer-alliance-inc
Boy Scouts Of America	/org/boy-scouts-of-america-288
Gildas Club Madison Wisconsin Inc	/org/gildas-club-madison-wisconsin-inc
Pride of the Midwest Girls Fast Pitch Softball Club	/org/pride-of-the-midwest-girls-fast-pitch-softball-club
New Beginnings Shih Tzu Rescue Inc	/org/new-beginnings-shih-tzu-rescue-inc
Peace Learning Center of Milwaukeeinc	/org/peace-learning-center-of-milwaukeeinc
St Francis Horse Rescue & Retirement Farm Inc	/org/st-francis-horse-rescue-retirement-farm-inc
St Vincent De Paul Society Of Milwaukee	/org/st-vincent-de-paul-society-of-milwaukee
Potters House Association International, Inc	/org/potters-house-association-international-inc
Wisconsin Big Cat Rescue and Educational Center	/org/wisconsin-big-cat-rescue-and-educational-center
Family Resource Center St. Croix Valley, Inc.	/org/family-resource-center-st-croix-valley-inc
Northcentral Maltese Rescue, Inc.	/org/northcentral-maltese-rescue-inc
Growing Power Inc	/org/growing-power-inc
Winds Of The Spirit Ministries Inc	/org/winds-of-the-spirit-ministries-inc
Newfoundland Club of America Charitable Trust	/org/newfoundland-club-of-america-charitable-trust
Couleecap Inc	/org/couleecap-inc
Ventures In People Foundation Inc	/org/ventures-in-people-foundation-inc
Good News Project, Inc.	/org/good-news-project-inc
Kenosha Common Markets Inc	/org/kenosha-common-markets-inc
CJ Lomas Recovery Foundation U A	/org/cj-lomas-recovery-foundation-u-a
Midwest Organic And Sustainable Education Services Inc	/org/midwest-organic-and-sustainable-education-services-inc
Hike Fund	/org/hike-fund
Jewish Museum Milwaukee	/org/jewish-museum-milwaukee
Children of the fallen	/org/children-of-the-fallen
Peninsula School of Art, Inc.	/org/peninsula-school-of-art-inc
Wisconsin Parkinson Association Inc	/org/wisconsin-parkinson-association-inc
Society Of St Francis	/org/society-of-st-francis
CARE NET PREGNANCY CENTER OF DANE COUNTY	/org/care-net-pregnancy-center-of-dane-county
River Revitalizational Foundation Inc	/org/river-revitalizational-foundation-inc
Fetch Wisconsin Rescue	/org/fetch-wisconsin-rescue
Northwoods Childrens Museum	/org/northwoods-childrens-museum
Second Harvest Foodbank of Southern Wisconsin	/org/second-harvest-foodbank-of-southern-wisconsin
Kenyahelp Inc	/org/kenyahelp-inc
Combat Blindness International Inc	/org/combat-blindness-international-inc
International Crane Foundation, Inc.	/org/international-crane-foundation-inc
TEENS FOR CHRIST	/org/teens-for-christ
PRINGLE NATURE CENTER	/org/pringle-nature-center
Youthaiti Inc	/org/youthaiti-inc
The Gardens - Managed by Independent Living, Inc.	/org/the-gardens-managed-by-independent-living-inc
GOOD FRIEND INC	/org/good-friend-inc
Soar-Kenya Inc	/org/soar-kenya-inc
Jeremiahs Crossing Inc	/org/jeremiahs-crossing-inc
COA Youth & Family Centers	/org/coa-youth-family-centers
Call In On Crime Inc	/org/call-in-on-crime-inc
St Lucas Lutheran Church	/org/st-lucas-lutheran-church-1
Big Brothers And Big Sisters Of Metropolitan Milwaukee Inc	/org/big-brothers-and-big-sisters-of-metropolitan-milwaukee-inc
World Ties Ltd	/org/world-ties-ltd
Wisconsin Breast Cancer Coalition Inc	/org/wisconsin-breast-cancer-coalition-inc
Boy Scouts Of America	/org/boy-scouts-of-america-404
Community Benefit Tree Inc	/org/community-benefit-tree-inc
Friends And Family Cancer Foundation Ffcf Inc	/org/friends-and-family-cancer-foundation-ffcf-inc
Deaf Connections Inc	/org/deaf-connections-inc
Sevastopol Education Foundation Inc	/org/sevastopol-education-foundation-inc
Mama Deltas Lovehouse	/org/mama-deltas-lovehouse
Fishing has no boundaries, inc	/org/fishing-has-no-boundaries-inc
Wilson Disease Association	/org/wilson-disease-association
Public Allies Inc	/org/public-allies-inc
ONEIDA COUNTY HUMANE SOCIETY	/org/oneida-county-humane-society
St Francis Society For The Prevention Of Cruelty To Animals I	/org/st-francis-society-for-the-prevention-of-cruelty-to-animals-i
KANDU Industries Inc.	/org/kandu-industries-inc
BOYS AND GIRLS CLUB OF PORTAGE COUNTY INC	/org/boys-and-girls-club-of-portage-county-inc
Women In Trucking Association Inc	/org/women-in-trucking-association-inc
Local Unions No 19 & 127 Health And Welfare Fund	/org/local-unions-no-19-127-health-and-welfare-fund
Interfaith Senior Programs Inc	/org/interfaith-senior-programs-inc
Worldbuilders Inc	/org/worldbuilders-inc
Milwaukee Pets Alive Inc	/org/milwaukee-pets-alive-inc
FOND DU LAC HUMANE SOCIETY INC	/org/fond-du-lac-humane-society-inc
PONY TALES REFUGE AND REHAB INC	/org/pony-tales-refuge-and-rehab-inc
Toddlers And Kids On A Mission	/org/toddlers-and-kids-on-a-mission
Bright Young Dyslexics Foundation Inc	/org/bright-young-dyslexics-foundation-inc
Families-In-Transition Support Network	/org/families-in-transition-support-network
Coltons Cure Foundation Inc	/org/coltons-cure-foundation-inc
Aviators By Design Inc	/org/aviators-by-design-inc
Great Wisconsin Headwaters Trail System Foundation	/org/great-wisconsin-headwaters-trail-system-foundation
Education Matters Inc	/org/education-matters-inc-1
Rape Crisis Center, Inc.	/org/rape-crisis-center-inc
Boys & Girls Club of Oshkosh, Inc.	/org/boys-girls-club-of-oshkosh-inc
Advocates For Victims Of Domestic &Sexual Abuse In Langlade Cnty Inc	/org/advocates-for-victims-of-domestic-sexual-abuse-in-langlade-cnty-inc
Friends Of Horicon International Education Center Inc	/org/friends-of-horicon-international-education-center-inc
Community Advocates Inc	/org/community-advocates-inc
Central Wisconsin Literacy Council	/org/central-wisconsin-literacy-council
Grantsburg Hockey Association	/org/grantsburg-hockey-association
Food Pantry Of Waukesha County Inc	/org/food-pantry-of-waukesha-county-inc
Metropolitan Milwaukee Fair Housing Council Inc	/org/metropolitan-milwaukee-fair-housing-council-inc
Omega School Inc	/org/omega-school-inc
Sheboygan Society Of Scale Model Railroad Engineers Limited	/org/sheboygan-society-of-scale-model-railroad-engineers-limited
Center For Veterans Issues Limited	/org/center-for-veterans-issues-limited
Lss Foundation Inc	/org/lss-foundation-inc
Ronald Mcdonald House Charities Of Marshfield Inc	/org/ronald-mcdonald-house-charities-of-marshfield-inc
We Are Hope Inc	/org/we-are-hope-inc
We The Children Fund Inc	/org/we-the-children-fund-inc
Door County Land Trust Inc	/org/door-county-land-trust-inc
Alano Club Of Wausau Inc 711 Mc Clellan Street	/org/alano-club-of-wausau-inc-711-mc-clellan-street
Integrated Community Work Inc	/org/integrated-community-work-inc
FORT WILDERNESS MINISTRIES INCORPORATED	/org/fort-wilderness-ministries-incorporated
New Hope Center Inc	/org/new-hope-center-inc
Milwaukee World Festival Inc	/org/milwaukee-world-festival-inc
GREEN LAKE FESTIVAL OF MUSIC	/org/green-lake-festival-of-music
Early Music Now Inc	/org/early-music-now-inc
Friends Of Abused Families Inc	/org/friends-of-abused-families-inc
Chain Skimmers Water Ski Team Inc	/org/chain-skimmers-water-ski-team-inc
Senior Resource Center Inc	/org/senior-resource-center-inc
Laura And Peter Mossakowski Family Dog Park Ltd	/org/laura-and-peter-mossakowski-family-dog-park-ltd
Raptor Education Group Inc	/org/raptor-education-group-inc
Community Clothes Closet Inc	/org/community-clothes-closet-inc
ANGEL ON MY SHOULDER LTD	/org/angel-on-my-shoulder-ltd
Satellite Child Care, Inc.	/org/satellite-child-care-inc
Intervarsity Christian Fellowship-USA	/org/intervarsity-christian-fellowship-usa-2
Wisconsin Alliance For Fire Safety Inc	/org/wisconsin-alliance-for-fire-safety-inc
Tall Pines Conservancy Inc	/org/tall-pines-conservancy-inc
CLUB KIDS IN DANGER SAVED CLUB KIDS INC	/org/club-kids-in-danger-saved-club-kids-inc
Caritas For Children Inc	/org/caritas-for-children-inc
Operation Bootstrap Inc	/org/operation-bootstrap-inc-1
Invasive Plants Association Of Wisconsin Incorporated	/org/invasive-plants-association-of-wisconsin-incorporated
Green Acres Boxer Rescue Of Wisconsin Inc	/org/green-acres-boxer-rescue-of-wisconsin-inc
Kettle Moraine Land Trust	/org/kettle-moraine-land-trust
Randlin Adult Family Care Homes Inc	/org/randlin-adult-family-care-homes-inc
Boys & Girls Clubs Of Barron County Inc	/org/boys-girls-clubs-of-barron-county-inc
Human Development Center Inc	/org/human-development-center-inc-1
Wausau Tide Swim Club	/org/wausau-tide-swim-club
Feline & Canine Friends Inc	/org/feline-canine-friends-inc-1
Rethinking Schools Limited	/org/rethinking-schools-limited
Humane Society of Portage County INC	/org/humane-society-of-portage-county-inc
Wisconsin Womens Network Inc	/org/wisconsin-womens-network-inc
Aglow International	/org/aglow-international-189
Chamber Of Commerce Greater Beloit Foundation Inc	/org/chamber-of-commerce-greater-beloit-foundation-inc
Fine Arts Foundation of the Westby Area	/org/fine-arts-foundation-of-the-westby-area
Ask Second Chance Home Inc	/org/ask-second-chance-home-inc
Hand-N-Hand Of Northeastern Wisconsin Inc	/org/hand-n-hand-of-northeastern-wisconsin-inc
Black Oak Lake Preservation Foundation Inc	/org/black-oak-lake-preservation-foundation-inc
Cornucopia Institute Incorporated	/org/cornucopia-institute-incorporated
Kindred Kitties Ltd	/org/kindred-kitties-ltd
Professional Learning Institute Staff Cooperative	/org/professional-learning-institute-staff-cooperative
State Environmental Leadership Program Inc	/org/state-environmental-leadership-program-inc
GIRLS ON THE RUN OF DANE COUNTY, INC.	/org/girls-on-the-run-of-dane-county-inc
Maggie And Keegan Hackett Fund For Special Needs Children	/org/maggie-and-keegan-hackett-fund-for-special-needs-children
Wisdom Inc	/org/wisdom-inc-4
Valley Academy For The Arts Inc	/org/valley-academy-for-the-arts-inc
Motorcycle And Model Railroad Museum	/org/motorcycle-and-model-railroad-museum
Saint Croix Animal Friends Inc	/org/saint-croix-animal-friends-inc
Animal Rescue And Farm Santuary Inc	/org/animal-rescue-and-farm-santuary-inc
Friends Of Mead Public Library	/org/friends-of-mead-public-library
Isaiah 61 Ministries	/org/isaiah-61-ministries
River Food Pantry	/org/river-food-pantry
Faith Community Church	/org/faith-community-church-23
Wolf River Artisans Guild	/org/wolf-river-artisans-guild
Compassionate Paws Inc	/org/compassionate-paws-inc
New Beginnings Pregnancy Care Center Inc	/org/new-beginnings-pregnancy-care-center-inc
Milwaukee Urban Garden Inc	/org/milwaukee-urban-garden-inc
Wisconsin Puppy Mill Project	/org/wisconsin-puppy-mill-project
Body Of Christ Ministries	/org/body-of-christ-ministries_100827738
Dane County Friends Of Ferals	/org/dane-county-friends-of-ferals
SAINT TERESA OF CALCUTTA PARISH	/org/saint-teresa-of-calcutta-parish
Friends Of Lakeshore State Park	/org/friends-of-lakeshore-state-park
La Crosse Loggers Foundation Inc	/org/la-crosse-loggers-foundation-inc
Stable Life Inc	/org/stable-life-inc
Don Shire Ministries Inc	/org/don-shire-ministries-inc
Lucy Burns Institute Inc	/org/lucy-burns-institute-inc
Dells-Delton Ems Inc	/org/dells-delton-ems-inc
Willow Creek Ranch Inc	/org/willow-creek-ranch-inc
Happy Tonics	/org/happy-tonics
Shelter From The Storm Animal Rescue Inc	/org/shelter-from-the-storm-animal-rescue-inc
John K Maciver Institute For Public Policy Inc	/org/john-k-maciver-institute-for-public-policy-inc
United Way Blackhawk Region Inc	/org/united-way-blackhawk-region-inc
Pathways Church Inc	/org/pathways-church-inc
Shell Lake Arts Center Inc	/org/shell-lake-arts-center-inc
Community Closet Resale	/org/community-closet-resale
Goodwill Industries Of South Central Wisconsin Inc	/org/goodwill-industries-of-south-central-wisconsin-inc
Boys And Girls Club Of Greater Milwaukee Inc	/org/boys-and-girls-club-of-greater-milwaukee-inc
9to5 National Association of Working Women	/org/9to5-national-association-of-working-women
Breast Cancer Recovery Foundation Inc	/org/breast-cancer-recovery-foundation-inc
Wisconsin Demolay Foundation	/org/wisconsin-demolay-foundation
Kathys House Inc	/org/kathys-house-inc-1
UNITED COMMUNITY CENTER INC	/org/united-community-center-inc
Eau Claire County Humane Association Inc	/org/eau-claire-county-humane-association-inc
Better Care Family Services Inc	/org/better-care-family-services-inc
Milwaukee Symphony Orchestra Inc	/org/milwaukee-symphony-orchestra-inc
Wildlife in Need Center	/org/wildlife-in-need-center
United Way Of Dane County Inc	/org/united-way-of-dane-county-inc-1
East Troy Area Historical Society Inc	/org/east-troy-area-historical-society-inc
The Womens Center Inc	/org/the-womens-center-inc-1
Land O Lakes Historical Society Inc	/org/land-o-lakes-historical-society-inc
Nami Waukesha Inc	/org/nami-waukesha-inc
ANGELS WISH INC	/org/angels-wish-inc
Service League Of Green Bay Inc	/org/service-league-of-green-bay-inc
Stout University Foundation Inc	/org/stout-university-foundation-inc
The Animal Lobby Inc	/org/the-animal-lobby-inc
Business Against Drunk Drivers, Inc.	/org/business-against-drunk-drivers-inc
Milwaukee Ballet Company Inc	/org/milwaukee-ballet-company-inc
Waukesha Express Swim Team Inc	/org/waukesha-express-swim-team-inc
ORGANISATION MODIALE DE GASTROENTEROLOGIE	/org/organisation-modiale-de-gastroenterologie
American Academy of Cosmetic Dentistry Charitable Foundation, Inc.	/org/american-academy-of-cosmetic-dentistry-charitable-foundation-inc
Wisconsin History Foundation Inc	/org/wisconsin-history-foundation-inc
Progressive Inc	/org/progressive-inc
Coulee Jass Inc	/org/coulee-jass-inc
National Alliance On Mental Illness Of Fond Du Lac Co Inc	/org/national-alliance-on-mental-illness-of-fond-du-lac-co-inc
Gilbert Brown Foundation	/org/gilbert-brown-foundation
Good Neighbor Clinic Of Sauk Prairie	/org/good-neighbor-clinic-of-sauk-prairie
Raymond Youth Baseball Inc	/org/raymond-youth-baseball-inc
WISE WOMEN GATHERING PLACE INC	/org/wise-women-gathering-place-inc
Touching Smiles Equine Therapy Inc	/org/touching-smiles-equine-therapy-inc
Wise Resources Inc	/org/wise-resources-inc
Green Bay And Western Historical Society Inc	/org/green-bay-and-western-historical-society-inc
Racine Explorer & Scout Drum & Bugle Corps Inc	/org/racine-explorer-scout-drum-bugle-corps-inc
Mequon-Thiensville Education Foundation Inc	/org/mequon-thiensville-education-foundation-inc
Potosi Foundation Inc	/org/potosi-foundation-inc
Kan Cool For School Inc	/org/kan-cool-for-school-inc
Ours Through Adoption Of Northeastern Wisconsin Inc	/org/ours-through-adoption-of-northeastern-wisconsin-inc
Friends Of Peninsula State Parkincorporated	/org/friends-of-peninsula-state-parkincorporated
SAFE PLACE FOR NEWBORNS OF WISC INC	/org/safe-place-for-newborns-of-wisconsin
Northwoods Land Trust Inc	/org/northwoods-land-trust-inc
PORTFISH LTD	/org/port-washington-maritime-heritage-experience-inc
Protective Animal Welfare Society Of Western Wisconsin	/org/protective-animal-welfare-society-of-western-wisconsin
Fox Cities Kurgan Sister Cities Program Inc	/org/fox-cities-kurgan-sister-cities-program-inc
Restore Innocence Ranch, Inc.	/org/restore-innocence-ranch-inc
LOS TOROS FOUNDATION	/org/los-toros-foundation
First American Prevention Center Inc	/org/first-american-prevention-center-inc
Ozaukee Washington Land Trust Inc	/org/ozaukee-washington-land-trust-inc
Accident Scene Management Inc	/org/accident-scene-management-inc
Butternut Area Historical Society Inc	/org/butternut-area-historical-society-inc
PROJECT ANGEL HUGS	/org/project-angel-hugs
Community Action Coaltion For South Central Wisconsin Inc	/org/community-action-coaltion-for-south-central-wisconsin-inc
House Rabbit Society Wisconsin Chapter	/org/house-rabbit-society-wisconsin-chapter
Great Lakes Irish Setter Rescue	/org/great-lakes-irish-setter-rescue
Rekindle The Flame Ministries	/org/rekindle-the-flame-ministries
Blueprint Student-Athlete Services	/org/blueprint-student-athlete-services
Natural Heritage Land Trust Inc	/org/natural-heritage-land-trust-inc
Idea Foundation Of Colby Inc	/org/idea-foundation-of-colby-inc
Anns Hope Foundation Inc	/org/anns-hope-foundation-inc
Badger Childhood Cancer Network, Inc.	/org/badger-childhood-cancer-network-inc
Fellow Mortals Wild Life Hospital Foundation Inc	/org/fellow-mortals-wild-life-hospital-foundation-inc
Outstretched Hands Of Romania Inc	/org/outstretched-hands-of-romania-inc
Lifestriders Inc	/org/lifestriders-inc
Ice Age Trail Alliance	/org/ice-age-trail-alliance
Dane County Parent Council Inc	/org/dane-county-parent-council-inc
REVIVAL FIRES EVANGELISTIC ASSO CORP FOOD BANK	/org/revival-fires-evangelistic-asso-corp-food-bank
Fox Valley Brain Tumor Coalition Inc	/org/fox-valley-brain-tumor-coalition-inc
Westby Norse Scholarship Fund	/org/westby-norse-scholarship-fund
CLEAN WISCONSIN INC	/org/clean-wisconsin-inc
Repairers Of The Breach Inc	/org/repairers-of-the-breach-inc-2
South Milwaukee Human Concerns Inc	/org/south-milwaukee-human-concerns-inc
La Casa De Esperanza	/org/la-casa-de-esperanza
Watertown Food Pantry Inc	/org/watertown-food-pantry-inc
Sussex Antique Power Association Inc	/org/sussex-antique-power-association-inc
Prairie Enthusiasts Inc	/org/prairie-enthusiasts-inc
Seven Rivers Figure Skating Clubinc	/org/seven-rivers-figure-skating-clubinc
Friends Of The Berlin Senior Center Inc	/org/friends-of-the-berlin-senior-center-inc
Pauls Pantry Inc	/org/pauls-pantry-inc
Bountiful Harvest Of Faith Ministries Inc	/org/bountiful-harvest-of-faith-ministries-inc
RACINE SYMPHONY ORCHESTRA ASSOCIATION INC	/org/racine-symphony-orchestra-association-inc
Global Orphan Outreach Inc	/org/global-orphan-outreach-inc
Volunteer Intertribal Medicine Inc	/org/volunteer-intertribal-medicine-inc
Girl Scouts Of Birch Trails Council Wi Inc	/org/girl-scouts-of-birch-trails-council-wi-inc
People Care Inc	/org/people-care-inc-2
Living Hope International Inc	/org/living-hope-international-inc
West Wisconsin Land Trust Inc	/org/west-wisconsin-land-trust-inc
Boxes Of Love Ltd	/org/boxes-of-love-ltd_100003406
Riverway Communities Of Hope	/org/riverway-communities-of-hope
Wisconsin Capitol Pride	/org/wisconsin-capitol-pride
Lake Geneva Fresh Air Association	/org/lake-geneva-fresh-air-association
Friends Of Pheasant Branch Conservancy Inc	/org/friends-of-pheasant-branch-conservancy-inc
WISCONSIN BADGER CAMP INC	/org/wisconsin-badger-camp-inc
Green Bay Community Theater	/org/green-bay-community-theater
Blue Mountain Project	/org/blue-mountain-project
St Nicholas Mission	/org/st-nicholas-mission
Bayfield Regional Conservancy Inc	/org/bayfield-regional-conservancy-inc
Highland Community School Inc	/org/highland-community-school-inc
Agape Of Appleton Inc	/org/agape-of-appleton-inc
My Home, Your Home Inc.	/org/my-home-your-home-inc-1
Boys & Girls Club Of Janesville	/org/boys-girls-club-of-janesville
Door County Humane Society Inc	/org/door-county-humane-society-inc
Another Hand Foudation Inc	/org/another-hand-foudation-inc
Elmbrook Humane Society Inc	/org/elmbrook-humane-society-inc
Theatre In The Woods Limited	/org/theatre-in-the-woods-limited
Appleton Lodge No 367 Loyal Order Of Moose	/org/appleton-lodge-no-367-loyal-order-of-moose
Fox Valley Technical College Foundation Inc	/org/fox-valley-technical-college-foundation-inc
Aldo Leopold Foundation Inc	/org/aldo-leopold-foundation-inc
Shorewood High School Alumni Association	/org/shorewood-high-school-alumni-association
National Pku Alliance Inc	/org/national-pku-alliance-inc
Mississippi Valley Conservancy Inc	/org/mississippi-valley-conservancy-inc
Fort Atkinson Garden Club	/org/fort-atkinson-garden-club
Mptv Friends Inc	/org/mptv-friends-inc
Forward Mutual Insurance Company	/org/forward-mutual-insurance-company
Family Advocates Inc	/org/family-advocates-inc
BRIDGE TO HOPE INC	/org/bridge-to-hope-inc
Goshen Childrens Home Inc	/org/goshen-childrens-home-inc
Wisconsin State Telecommunications Association Inc	/org/wisconsin-state-telecommunications-association-inc
Kinnickinnic River Land Trust Inc	/org/kinnickinnic-river-land-trust-inc
Pioneer Drum And Bugle Corps Inc	/org/pioneer-drum-and-bugle-corps-inc
CALEDONIA CONSERVANCY LTD	/org/caledonia-conservancy-ltd
Trogs Mc Llc	/org/trogs-mc-llc
Forward Janesville Inc	/org/forward-janesville-inc
National Lung Cancer Partnership	/org/national-lung-cancer-partnership-1
International Foundation For Functional Gastrointestinal Disord	/org/international-foundation-for-functional-gastrointestinal-disord
The Fix Is In Inc	/org/the-fix-is-in-inc
Rainbird Foundation Inc	/org/rainbird-foundation-inc
The Natural Step Monona Ltd	/org/the-natural-step-monona-ltd
Little Paws Animal Health Inc	/org/little-paws-animal-health-inc
Wisconsin Family Action Inc	/org/wisconsin-family-action-inc
Hunger Task Force Inc	/org/hunger-task-force-inc
Olbrich Botanical Society Inc	/org/olbrich-botanical-society-inc
NORTHWOODS HUMANE SOCIETY	/org/northwoods-humane-society
Banting School Pto Inc	/org/banting-school-pto-inc
SINGING ROOSTER INC	/org/singing-rooster-inc
Gentle Hands Animal Rescue & Rehabilitation Inc	/org/gentle-hands-animal-rescue-rehabilitation-inc
Random Lake Area Interfaith Food Pantry Inc	/org/random-lake-area-interfaith-food-pantry-inc
Rotary International	/org/rotary-international-1415
Cannedwater4kids Inc	/org/cannedwater4kids-inc
Tri 4 Schools Inc.	/org/tri-4-schools-inc
Jurnie's Shelter	/org/jurnies-shelter
Ehlers Danlos Syndrome Network Cares	/org/ehlers-danlos-syndrome-network-cares
Tychicus Ministries Inc	/org/tychicus-ministries-inc
Volunteer Connection Inc	/org/volunteer-connection-inc
Doberman Rescue Alliance Of Wisconsin Inc	/org/doberman-rescue-alliance-of-wisconsin-inc
Encompass Early Education And Care Inc	/org/encompass-early-education-and-care-inc
Kompost Kids Inc	/org/kompost-kids-inc
Changing Lives Assembly of God (Community Service & Outreach)	/org/changing-lives-assembly-of-god-community-service-outreach
Open Arms Free Clinic Inc	/org/open-arms-free-clinic-inc
Nc3-National Coalition Of Certification Centers Inc	/org/nc3-national-coalition-of-certification-centers-inc
Dads Of Wisconsin Inc	/org/dads-of-wisconsin-inc
Adams County Humane Society Inc	/org/adams-county-humane-society-inc
Myteam Triumph	/org/myteam-triumph
Hartford Wrestling Club Inc	/org/hartford-wrestling-club-inc
Atv 4 Vets Ltd	/org/atv-4-vets-ltd
New Directions Learning Community Inc	/org/new-directions-learning-community-inc
Quarter Moon Acres Inc	/org/quarter-moon-acres-inc
WINDS RECOVERY HOUSE, INC	/org/winds-recovery-house-inc
Womans Club Of Pewaukee	/org/womans-club-of-pewaukee
Lancer Youth Wrestling Club	/org/lancer-youth-wrestling-club
Seva Circle	/org/seva-circle
JLS Swimming Memorial	/org/jls-swimming-memorial
Tillys Pit Crew	/org/tillys-pit-crew
Eagle South Mountain Charter Inc	/org/eagle-south-mountain-charter-inc
Newfoundland Club Of America Inc	/org/newfoundland-club-of-america-inc
David B Tyriver Memorial Foundation Inc	/org/david-b-tyriver-memorial-foundation-inc
Western Publishing Needy Family Fund, Inc.	/org/western-publishing-needy-family-fund-inc
Waukesha Area Chamber Of Commerce Foundation Inc	/org/waukesha-area-chamber-of-commerce-foundation-inc
Parents For Public Schools, Inc.	/org/parents-for-public-schools-inc_33033
Hk Systems Inc	/org/hk-systems-inc
Milwaukee Kollel Inc	/org/milwaukee-kollel-inc
Calvary Chapel Of Wisconsin Rapids	/org/calvary-chapel-of-wisconsin-rapids
Dove Agency Inc	/org/dove-agency-inc
Iberian Spanish Dancers Inc	/org/iberian-spanish-dancers-inc
Gabriels Villa Inc	/org/gabriels-villa-inc
Hannah F Obrien Tr Uw 35084510	/org/hannah-f-obrien-tr-uw-35084510
Sigma Theta Tau Inc	/org/sigma-theta-tau-inc-142
National Dairy Shrine	/org/national-dairy-shrine
Carl B Thompson Trust 0202101	/org/carl-b-thompson-trust-0202101
Menomonee Falls Festivals Corporation	/org/menomonee-falls-festivals-corporation
Toastmasters International	/org/toastmasters-international-5107
Expeditions Unlimited Ltd	/org/expeditions-unlimited-ltd
Beta Alpha Psi National Council	/org/beta-alpha-psi-national-council-112
Aem Education Foundation	/org/aem-education-foundation
Lakeshore Communications Inc	/org/lakeshore-communications-inc
N U Yoga Ashrama In America	/org/n-u-yoga-ashrama-in-america
Midwest Center For Environmental Science And Public Policy	/org/midwest-center-for-environmental-science-and-public-policy
