org_name	org_url
The Caring Center Inc	/org/the-caring-center-inc-1
Heart Mountain Crisis Pregnancy Center	/org/heart-mountain-crisis-pregnancy-center
National Outdoor Leadership School	/org/national-outdoor-leadership-school
Trailblazer Foundation	/org/trailblazer-foundation
Biodiversity Conservation Alliance	/org/biodiversity-conservation-alliance
Black Dog Animal Rescue	/org/black-dog-animal-rescue
Held Your Whole Life, Inc	/org/held-your-whole-life-inc
Pryor Mountain Wild Mustang Center Inc	/org/pryor-mountain-wild-mustang-center-inc
Powder River Basin Resource Council	/org/powder-river-basin-resource-council
BRAVE C A T S CHILDREN AND THEIR STRUGGLES INC	/org/brave-c-a-t-s-children-and-their-struggles-inc
Paws and Claws Animal Adoption and Care Center	/org/paws-and-claws-animal-adoption-and-care-center
Good Samaritan Mission	/org/good-samaritan-mission-1
The Kindness Ranch Animal Sanctuary	/org/the-kindness-ranch-animal-sanctuary
YELLOWSTONE ASSOCIATION	/org/yellowstone-association
Volunteer Teacher Thailand	/org/volunteer-teacher-thailand
Childrens Discovery Center	/org/childrens-discovery-center-1
Central Wyoming Rescue Mission	/org/central-wyoming-rescue-mission
Knights Of Columbus	/org/knights-of-columbus-2106
Lander Pet Connection Inc	/org/lander-pet-connection-inc
Compass Center For Families	/org/compass-center-for-families
Habitat For Humanity International Inc	/org/habitat-for-humanity-international-inc-1421
CHEYENNE REGIONAL FOUNDATION	/org/cheyenne-regional-foundation
Wyoming Association For Creative Youth W A C Y	/org/wyoming-association-for-creative-youth-w-a-c-y
Family Promise Of Casper Inc	/org/family-promise-of-casper-inc
Vision Beyond Borders	/org/vision-beyond-borders
Frontier School Of The Bible	/org/frontier-school-of-the-bible
Table In The Wilderness Ministries	/org/table-in-the-wilderness-ministries
Buffalo Bill Memorial Association	/org/buffalo-bill-memorial-association
Mercer Family Resource Center	/org/mercer-family-resource-center
Building The Wyoming We Want	/org/building-the-wyoming-we-want
Laramie Project Graduation	/org/laramie-project-graduation
Pet Partners Of Carbon County	/org/pet-partners-of-carbon-county
Foundations Of Liberty Inc	/org/foundations-of-liberty-inc
Heart Mountain Japanese-American Memorial Foundation Inc	/org/heart-mountain-japanese-american-memorial-foundation-inc
Normative Services Inc	/org/normative-services-inc
YOUTH FOR CHRIST USA INC	/org/youth-for-christ-usa-inc-6
Childrens Western Wish Foundation	/org/childrens-western-wish-foundation
Jasons Friends Foundation Inc	/org/jasons-friends-foundation-inc
Wyoming Stock Growers Agricultural	/org/wyoming-stock-growers-agricultural
Mary Bennion Foundation	/org/mary-bennion-foundation
Casper Family Ymca	/org/casper-family-ymca
CHEYENNE INTERFAITH HOSPITALITY NETWORK INC (Interfaith Family Support Services)	/org/cheyenne-interfaith-hospitality-network-inc-interfaith-family-support-servi
Community Resource Center Interagency - Rawlins	/org/community-resource-center-interagency-rawlins
Sheridan Angels Inc	/org/sheridan-angels-inc
Wyoming Food Bank Of The Rockies	/org/wyoming-food-bank-of-the-rockies
Jackson Hole Land Trust	/org/jackson-hole-land-trust
Meals On Wheels Of Cheyenne Inc	/org/meals-on-wheels-of-cheyenne-inc
Josh Nelson Foundation	/org/josh-nelson-foundation
Wyoming State Historical Society	/org/wyoming-state-historical-society
Noah Webster Christian School Inc	/org/noah-webster-christian-school-inc
The Johnson County Search And Rescue Unit	/org/the-johnson-county-search-and-rescue-unit
Point Man International Ministries	/org/point-man-international-ministries_9487
International Reading Association, Inc.	/org/international-reading-association-inc-19
Riverside Plaza Two Inc	/org/riverside-plaza-two-inc
DANCERS WORKSHOP	/org/dancers-workshop
Teton Youth & Family Services Inc	/org/teton-youth-family-services-inc
Pioneer Homestead	/org/pioneer-homestead
Protection & Advocacy System Inc	/org/protection-advocacy-system-inc
Valley Bible Church	/org/valley-bible-church
Child Evangelism Fellowship Inc	/org/child-evangelism-fellowship-inc_9543
Hots Springs County School District No 1 Education Endowment	/org/hots-springs-county-school-district-no-1-education-endowment
Neighborhood Alliance Church In Riverton Wyoming	/org/neighborhood-alliance-church-in-riverton-wyoming
Big Horn Enterprises Inc	/org/big-horn-enterprises-inc
Headwaters Community Arts And Conference Center Association	/org/headwaters-community-arts-and-conference-center-association
North East Wyoming Respite Care	/org/north-east-wyoming-respite-care
Friends Of Teton County Library	/org/friends-of-teton-county-library
Casper Swim Club	/org/casper-swim-club
Community Bible Church Of Jackson Hole	/org/community-bible-church-of-jackson-hole
Corner Stone Church Of The Open Bible	/org/corner-stone-church-of-the-open-bible
Wyoming National Guard Educational Endowment Fund	/org/wyoming-national-guard-educational-endowment-fund
Wyoming Symphony Orchestra	/org/wyoming-symphony-orchestra
Little People Learning Center Inc	/org/little-people-learning-center-inc
In Him Ministries Of Casper Wyoming	/org/in-him-ministries-of-casper-wyoming
Young Mens Christian Association Sheridan County	/org/young-mens-christian-association-sheridan-county
Child Evangelism Fellowship Inc	/org/child-evangelism-fellowship-inc_9514
4-H Clubs & Affiliated 4-H Organizations	/org/4-h-clubs-affiliated-4-h-organizations_9455
Wyoming Medical Center Foundation	/org/wyoming-medical-center-foundation
United Way Of Albany County Inc	/org/united-way-of-albany-county-inc
Services For Seniors Program Inc	/org/services-for-seniors-program-inc
Mother Seton Housing Inc	/org/mother-seton-housing-inc
Bear Project Inc	/org/bear-project-inc
Wyoming State Historical Society	/org/wyoming-state-historical-society_13527
Cody United Methodist Church Foundation	/org/cody-united-methodist-church-foundation
Medical Development Association	/org/medical-development-association
Dubois Volunteers Inc	/org/dubois-volunteers-inc
Carbon County Library Foundation Inc	/org/carbon-county-library-foundation-inc
Wyoming Arts Alliance	/org/wyoming-arts-alliance
Bishop Randall House, Inc.	/org/bishop-randall-house-inc
Casper Legion Baseball Club Inc	/org/casper-legion-baseball-club-inc
Hot Springs Memorial Hospital Auxiliary	/org/hot-springs-memorial-hospital-auxiliary
B O L D Inc	/org/b-o-l-d-inc
University Of Wyoming Research Corporation	/org/university-of-wyoming-research-corporation
Converse County Senior Housing Incorporated	/org/converse-county-senior-housing-incorporated
Wyoming Heritage Foundation	/org/wyoming-heritage-foundation
Wyoming Farm Bureau Foundation	/org/wyoming-farm-bureau-foundation
Converse County Library Foundation Inc	/org/converse-county-library-foundation-inc
Community Safety Network	/org/community-safety-network-2
Hot Springs County Library Foundation Inc	/org/hot-springs-county-library-foundation-inc
Pisgah Home Movement	/org/pisgah-home-movement
Trout Unlimited	/org/trout-unlimited-326
Little League Baseball Inc	/org/little-league-baseball-inc-280
Womens International Bowling Congress Inc	/org/womens-international-bowling-congress-inc_27967
Attention Home Inc	/org/attention-home-inc
Aglow International	/org/aglow-international-564
American Fisheries Society	/org/american-fisheries-society-39
Eastern Wyoming College Foundation	/org/eastern-wyoming-college-foundation
Trinity Lutheran Church	/org/trinity-lutheran-church-488
United Ostomy Association	/org/united-ostomy-association_60520
Nicolaysen Art Museum	/org/nicolaysen-art-museum
Jackson Youth Skating Inc	/org/jackson-youth-skating-inc
Wyoming Humanities Council	/org/wyoming-humanities-council
Alcova Community Foundation	/org/alcova-community-foundation
Eppson Center For Seniors Inc	/org/eppson-center-for-seniors-inc
Stride Learning Center	/org/stride-learning-center
Casper Clubhouse Inc	/org/casper-clubhouse-inc
Bethel Baptist Church	/org/bethel-baptist-church-127
Cheyenne Kiwanis Club Foundation	/org/cheyenne-kiwanis-club-foundation
American Legion Baseball Incorporated	/org/american-legion-baseball-incorporated
Cowboy Wrestling Club	/org/cowboy-wrestling-club
Joy Junction Childrens Church Inc	/org/joy-junction-childrens-church-inc
International Lutheran Laymens League	/org/international-lutheran-laymens-league
Mark Alan Doherty Scholarship Fund Inc	/org/mark-alan-doherty-scholarship-fund-inc
Homesteaders Museum Assn Inc	/org/homesteaders-museum-assn-inc
Childrens Center	/org/childrens-center
Women's Aglow Fellowship	/org/womens-aglow-fellowship_9504
Civil Air Patrol	/org/civil-air-patrol_9470
Hispanic Organization For Progress And Education	/org/hispanic-organization-for-progress-and-education
United Medical Center Unemployment Compensation Repayment Trust	/org/united-medical-center-unemployment-compensation-repayment-trust
Trinity Lutheran Church	/org/trinity-lutheran-church-655
Habitat For Humanity International Inc	/org/habitat-for-humanity-international-inc-1422
Jackson Hole Community Radio Incorporated	/org/jackson-hole-community-radio-incorporated
Corner Stone School	/org/corner-stone-school
Care And Share International	/org/care-and-share-international
Uinta County Library Foundation Inc	/org/uinta-county-library-foundation-inc
Habitat For Humanity International Inc	/org/habitat-for-humanity-international-inc-16
Powell Valley Health Care Inc	/org/powell-valley-health-care-inc
Cheyenne Greenway Foundation	/org/cheyenne-greenway-foundation
Land Of Goshen Ministries	/org/land-of-goshen-ministries
Wyoming Youth Services Association	/org/wyoming-youth-services-association
New Hope Humane Society	/org/new-hope-humane-society
Washakie Memorial Hospital Foundation Inc	/org/washakie-memorial-hospital-foundation-inc
Wyoming D A R E Incorporated	/org/wyoming-d-a-r-e-incorporated
Historic Trails Resource Conservation & Development Area	/org/historic-trails-resource-conservation-development-area
International Church Of The Foursquare Gospel	/org/international-church-of-the-foursquare-gospel-81
Gillette College Foundation	/org/gillette-college-foundation
Pronghorn Power Booster Club	/org/pronghorn-power-booster-club
The Community Food Closet Inc	/org/the-community-food-closet-inc
Victory Christian Fellowship	/org/victory-christian-fellowship_66204
Buffalo Bill Dam Visitors Center Inc	/org/buffalo-bill-dam-visitors-center-inc
Riverton Depot Foundation Fund	/org/riverton-depot-foundation-fund
Wyoming Human Services, Inc.	/org/wyoming-human-services-inc
Jackson Hole Community Housing	/org/jackson-hole-community-housing
International Church Of The Foursquare Gospel	/org/international-church-of-the-foursquare-gospel-82
Riverton Rotary Foundation	/org/riverton-rotary-foundation
Future Farmers Of America And Its State Associations & Local Chapter	/org/future-farmers-of-america-and-its-state-associations-local-chapter-292
First Baptist Church	/org/first-baptist-church_66216
Cheyenne All-City Childrens Chorus	/org/cheyenne-all-city-childrens-chorus
Albin Baptist Church	/org/albin-baptist-church
Encampment Preschool	/org/encampment-preschool
Shepherd Of The Mountains	/org/shepherd-of-the-mountains
Children And Nutrition Services	/org/children-and-nutrition-services
Teton Senior Housing Inc	/org/teton-senior-housing-inc
Heritage Christian School Inc	/org/heritage-christian-school-inc
Rock Springs Gymnastics Inc	/org/rock-springs-gymnastics-inc
Powell Valley Loaves And Fishes	/org/powell-valley-loaves-and-fishes
Wyoming Coalition For The Homeless	/org/wyoming-coalition-for-the-homeless
Calvary Baptist Church And Ministries	/org/calvary-baptist-church-and-ministries
Wyoming Rural Development Corp	/org/wyoming-rural-development-corp
Westward Heights Corp	/org/westward-heights-corp
Sweet Adelines International	/org/sweet-adelines-international_66239
North Hill Baptist Church	/org/north-hill-baptist-church
Lincoln-Uinta Child Development Association Incorporated	/org/lincoln-uinta-child-development-association-incorporated
Lander Wyoming Congregation Of Jehovahs Witnesses Inc	/org/lander-wyoming-congregation-of-jehovahs-witnesses-inc
Park County Library Foundation Incorporated	/org/park-county-library-foundation-incorporated
Good Shepherd Lutheran Church	/org/good-shepherd-lutheran-church-184
Pioneer Counseling Services	/org/pioneer-counseling-services
People Project	/org/people-project
Wamsutter Health Center Inc	/org/wamsutter-health-center-inc
University Of Wyoming Foundation	/org/university-of-wyoming-foundation
Northwest College Foundation	/org/northwest-college-foundation
Ironworkers Joint Apprenticeship Training Trust Of Wyoming	/org/ironworkers-joint-apprenticeship-training-trust-of-wyoming
Kemmerer Senior Citizens Center Inc	/org/kemmerer-senior-citizens-center-inc
Washakie County Senior Citizens Center	/org/washakie-county-senior-citizens-center
Cheyenne Animal Shelter-Services	/org/cheyenne-animal-shelter-services
Womens International Bowling Congress Inc	/org/womens-international-bowling-congress-inc_66263
Converse County Aging Services	/org/converse-county-aging-services
Cheyenne Womens Bowling Association	/org/cheyenne-womens-bowling-association
Southwest Sublette County Pioneers Inc	/org/southwest-sublette-county-pioneers-inc
Wyoming State Historical Society	/org/wyoming-state-historical-society_66267
Sweet Adelines International	/org/sweet-adelines-international_67822
Wyoming Governors Residence Foundation	/org/wyoming-governors-residence-foundation
Cheyenne American Legion Post Baseball Club Inc	/org/cheyenne-american-legion-post-baseball-club-inc
Fossil Country Futures Inc	/org/fossil-country-futures-inc
Izaak Walton League Of America Inc	/org/izaak-walton-league-of-america-inc-155
Sheridan County Memorial Hospital Foundation	/org/sheridan-county-memorial-hospital-foundation
Clarity Ministries International Inc	/org/clarity-ministries-international-inc
Trout Unlimited	/org/trout-unlimited-359
Womens International Bowling Congress Inc	/org/womens-international-bowling-congress-inc_84869
Womens International Bowling Congress Inc	/org/womens-international-bowling-congress-inc_93604
Clearmont Community Center Foundation	/org/clearmont-community-center-foundation
Truckers Christian Chapel Ministries West	/org/truckers-christian-chapel-ministries-west
Boys & Girls Clubs Of Central Wyoming	/org/boys-girls-clubs-of-central-wyoming
International Church Of The Foursquare Gospel	/org/international-church-of-the-foursquare-gospel-142
Toastmasters International	/org/toastmasters-international_116592
Dale A Hitz Ministries	/org/dale-a-hitz-ministries
Jeffrey City Foursquare Church	/org/jeffrey-city-foursquare-church
Future Farmers Of America State Associations & Local Chapter	/org/future-farmers-of-america-state-associations-local-chapter-371
Trapper Trails Council-Boy Scouts	/org/trapper-trails-council-boy-scouts
Kate Weis Memorial Hospital Fund	/org/kate-weis-memorial-hospital-fund
Sublette County Victim Assistance	/org/sublette-county-victim-assistance
Ring Lake Ranch Inc	/org/ring-lake-ranch-inc
Cornerstone Community Church Of Sheridan	/org/cornerstone-community-church-of-sheridan
Sheridan Stadium Foundation Inc	/org/sheridan-stadium-foundation-inc
Legal Services For Southeastern Wyoming Inc	/org/legal-services-for-southeastern-wyoming-inc
Meals On Wheels Foundation	/org/meals-on-wheels-foundation
United Way Of Converse County	/org/united-way-of-converse-county
Help For Health	/org/help-for-health
First Baptist Church Of Cody Wyoming	/org/first-baptist-church-of-cody-wyoming
Wyoming Council On Economic Education	/org/wyoming-council-on-economic-education
Wyoming State Historical Society	/org/wyoming-state-historical-society_66162
Yellowstone Behavioral Health Center	/org/yellowstone-behavioral-health-center
Wyoming Housing Opportunities	/org/wyoming-housing-opportunities
Wyoming Guardianship Corporation	/org/wyoming-guardianship-corporation
Grand Encampment Museum Inc	/org/grand-encampment-museum-inc
National Society Of The Daughters Of The American Revolution	/org/national-society-of-the-daughters-of-the-american-revolution-254
University Of Wyoming Alumni	/org/university-of-wyoming-alumni
Arc Of Natrona County	/org/arc-of-natrona-county
Regional State Museum Foundation Inc	/org/regional-state-museum-foundation-inc
Wyoming School Boards Association	/org/wyoming-school-boards-association
Jackson Hole Historical Society And Museum	/org/jackson-hole-historical-society-and-museum
Wyoming Independent Living Incorporated	/org/wyoming-independent-living-incorporated
Toastmasters International	/org/toastmasters-international-8302
Cheyenne Guitar Society Inc	/org/cheyenne-guitar-society-inc
The Corner Club, Inc.	/org/the-corner-club-inc
JACKSON HOLE WILDLIFE FOUNDATION	/org/jackson-hole-wildlife-foundation
Jackson Hole Figure Skating Club	/org/jackson-hole-figure-skating-club
Platte Valley Arts Council Inc	/org/platte-valley-arts-council-inc
Wyoming Music Educators Association	/org/wyoming-music-educators-association
Hannah House Of Sheridan, Inc.	/org/hannah-house-of-sheridan-inc
Bringing Resources Encouragement Assistance & Direction	/org/bringing-resources-encouragement-assistance-direction
Bill Waller Foundation	/org/bill-waller-foundation
Toastmasters International	/org/toastmasters-international_234430
Wyoming Om Association	/org/wyoming-om-association
Friends Of Community Recreation	/org/friends-of-community-recreation
Ironside Bird Rescue Inc	/org/ironside-bird-rescue-inc
Big Brothers Big Sisters Of Northwest Wyoming Inc	/org/big-brothers-big-sisters-of-northwest-wyoming-inc
Arc Of Wyoming	/org/arc-of-wyoming_122152
Sweetwater Aquatic Team	/org/sweetwater-aquatic-team
Wyoming Transportation Museum Corp	/org/wyoming-transportation-museum-corp
Kemmerer Foursquare Church	/org/kemmerer-foursquare-church
Hulett Emergency Medical Service Inc	/org/hulett-emergency-medical-service-inc
Grace Bible Church Of Gillette Wyoming	/org/grace-bible-church-of-gillette-wyoming
Albany Seniors, Inc.	/org/albany-seniors-inc
City-County Firefighters Burn Fund	/org/city-county-firefighters-burn-fund
The Wyoming Amateur Wrestling Association	/org/the-wyoming-amateur-wrestling-association
Cheyenne Frontier Days Memorial Foundation	/org/cheyenne-frontier-days-memorial-foundation
City Of Buffalo Charitable Foundation Inc	/org/city-of-buffalo-charitable-foundation-inc
Holy Trinity Housing Inc	/org/holy-trinity-housing-inc
Intermountain Agriculture Foundation	/org/intermountain-agriculture-foundation
Faith Bible Chapel Of Casper	/org/faith-bible-chapel-of-casper
St Paul Lutheran Church	/org/st-paul-lutheran-church-309
Emmanuel Bible Church Of Thayne Wyoming	/org/emmanuel-bible-church-of-thayne-wyoming
United Way Of Southwest Wyoming	/org/united-way-of-southwest-wyoming
Star Valley Senior Citizens Inc	/org/star-valley-senior-citizens-inc
First Christian Church	/org/first-christian-church-944
Converse County Humane Society	/org/converse-county-humane-society
Wyoming Nutritiion Services Inc	/org/wyoming-nutritiion-services-inc
Campbell County Humane Society	/org/campbell-county-humane-society
Cheyenne Frontier Days Old West Museum	/org/cheyenne-frontier-days-old-west-museum
Bible Baptist Temple	/org/bible-baptist-temple
Sublette Center	/org/sublette-center
National Society Of The Daughters Of The American Revolution	/org/national-society-of-the-daughters-of-the-american-revolution-480
Northwest Section Of The Ninety Nines	/org/northwest-section-of-the-ninety-nines-3
Southern Campbell County Emergencies Services Inc	/org/southern-campbell-county-emergencies-services-inc
Beacon Hill Baptist Church	/org/beacon-hill-baptist-church
Safehouse Services	/org/safehouse-services
Immanuel Lutheran Church	/org/immanuel-lutheran-church-355
Housing Partners Inc	/org/housing-partners-inc_290752
Green River Co-Op Preschool Inc	/org/green-river-co-op-preschool-inc
Shrine Bowl Of Wyoming Inc	/org/shrine-bowl-of-wyoming-inc
Parenteen	/org/parenteen
Wyoming State Historical Society	/org/wyoming-state-historical-society_125942
Safari Club International	/org/safari-club-international-128
Dude Ranch Educational Trust	/org/dude-ranch-educational-trust
Wyoming Wetlands Society	/org/wyoming-wetlands-society
Wyoming Alliance For Literacy, Inc.	/org/wyoming-alliance-for-literacy-inc
Niobrara County Library Foundation Inc	/org/niobrara-county-library-foundation-inc
Central Wyoming Softball Association	/org/central-wyoming-softball-association
Lions Of Wyoming Foundation Inc	/org/lions-of-wyoming-foundation-inc
Carbon County Public Broadcasting Foundation, Inc.	/org/carbon-county-public-broadcasting-foundation-inc
Friends Of The Sheridan Inn	/org/friends-of-the-sheridan-inn
Crimestoppers-Silent Witness Of Cheyenne Inc	/org/crimestoppers-silent-witness-of-cheyenne-inc
Christ Community Church	/org/christ-community-church-60
The Helluva Hunt Inc	/org/the-helluva-hunt-inc
Civil Air Patrol	/org/civil-air-patrol_134432
Trout Unlimited	/org/trout-unlimited-358
Womens International Bowling Congress Inc	/org/womens-international-bowling-congress-inc_140307
International Training In Communication	/org/international-training-in-communication_140394
Son Light Wesleyan Church	/org/son-light-wesleyan-church
Compassionate Friends, Inc.	/org/compassionate-friends-inc_148451
Womens International Bowling Congress Inc	/org/womens-international-bowling-congress-inc_149304
American Institute Of Chemical Engineers	/org/american-institute-of-chemical-engineers-59
Earth Walk	/org/earth-walk
Lutheran Womens Missionary League	/org/lutheran-womens-missionary-league-35
Centennial Valley Historical Association	/org/centennial-valley-historical-association
Paradise Valley Christian Church	/org/paradise-valley-christian-church
Trout Unlimited	/org/trout-unlimited-265
Bighorn Audubon Society	/org/bighorn-audubon-society
Laramie County Community College Foundation	/org/laramie-county-community-college-foundation
National Acupuncture Detoxification Association Inc	/org/national-acupuncture-detoxification-association-inc
Spence Foundation	/org/spence-foundation
National Ski Patrol System Inc	/org/national-ski-patrol-system-inc-5
International Reading Association, Inc.	/org/international-reading-association-inc-299
Bethel Outreach Ministries	/org/bethel-outreach-ministries
Helping Endangered Landmark Properties	/org/helping-endangered-landmark-properties
Arapahoe Lutheran Mission	/org/arapahoe-lutheran-mission
Big Horn County Library Foundation	/org/big-horn-county-library-foundation
Colorado Persian Society Inc	/org/colorado-persian-society-inc
Energy 2000 Forum In Aspen	/org/energy-2000-forum-in-aspen
Word Of Life Church Of God	/org/word-of-life-church-of-god
American Society Of Women Accountants Scholarship Fund	/org/american-society-of-women-accountants-scholarship-fund_178008
Women's International Bowling Congress, Inc.	/org/womens-international-bowling-congress-inc_178010
Women's International Bowling Congress, Inc.	/org/womens-international-bowling-congress-inc_178011
National Federation Of The Blind Of Wyoming	/org/national-federation-of-the-blind-of-wyoming
National Society Of The Sons Of The American Revolution	/org/national-society-of-the-sons-of-the-american-revolution-530
National Society Of The Daughters Of The American Revolution	/org/national-society-of-the-daughters-of-the-american-revolution-701
Northwest Community Action Programs Of Wyoming Inc	/org/northwest-community-action-programs-of-wyoming-inc
International Reading Association Inc	/org/international-reading-association-inc-301
Wyoming State Historical Society	/org/wyoming-state-historical-society_178019
Wyoming Field Science Foundation	/org/wyoming-field-science-foundation
Ruth Hawes Tuw First Methodist Church Of Laramie Wyoming	/org/ruth-hawes-tuw-first-methodist-church-of-laramie-wyoming
Friends Of Pathways	/org/friends-of-pathways-2
Harvest Rock Christian Fellowship	/org/harvest-rock-christian-fellowship
Wyoming Elks Association Charitable Trust	/org/wyoming-elks-association-charitable-trust
University Of Wyoming	/org/university-of-wyoming-318
Big Horn Basin Foundation Inc	/org/big-horn-basin-foundation-inc
Homeschoolers Of Wyoming	/org/homeschoolers-of-wyoming
Western Institute Of Leadership For Life	/org/western-institute-of-leadership-for-life
Douglas Youth Hockey Association	/org/douglas-youth-hockey-association
Trial Lawyers College	/org/trial-lawyers-college-1
Boys And Girls Club Of Park County Wyoming	/org/boys-and-girls-club-of-park-county-wyoming
United States Amateur Boxing Inc	/org/united-states-amateur-boxing-inc-43
Choices Alcohol Drug And Behavioral Help Center Inc	/org/choices-alcohol-drug-and-behavioral-help-center-inc
Sheridan County Ambulance Foundation Inc	/org/sheridan-county-ambulance-foundation-inc
Pacesetter 4-H Club	/org/pacesetter-4-h-club
Central Wyoming Family Planning Clinic Inc	/org/central-wyoming-family-planning-clinic-inc
Pinedale Hockey Association	/org/pinedale-hockey-association
Esterbrook Community Association	/org/esterbrook-community-association
Imitate The Image Ministries	/org/imitate-the-image-ministries
Friends Of The Albany County Public Library	/org/friends-of-the-albany-county-public-library
Central Wyoming Astronomical Society	/org/central-wyoming-astronomical-society
National Society Of The Daughters Of The American Revolution	/org/national-society-of-the-daughters-of-the-american-revolution-702
Let's Ride-Wyoming's Special Horsemen	/org/lets-ride-wyomings-special-horsemen
Water For Wildlife Foundation	/org/water-for-wildlife-foundation
Vore Buffalo Jump Foundation	/org/vore-buffalo-jump-foundation
Wyoming Riparian Association	/org/wyoming-riparian-association
Basin City Arts Center	/org/basin-city-arts-center
Cody Community Theatre	/org/cody-community-theatre
Healthy Infant Capable Adolescent Project	/org/healthy-infant-capable-adolescent-project
National Bighorn Sheep Interpretive Association Inc	/org/national-bighorn-sheep-interpretive-association-inc
Church Of The Open Bible	/org/church-of-the-open-bible_178073
Wyoming Science Teachers Association	/org/wyoming-science-teachers-association
United Fund Of Natrona County Foundation	/org/united-fund-of-natrona-county-foundation
Aglow International	/org/aglow-international-929
Hands In Harmony Inc	/org/hands-in-harmony-inc
National Society Colonial Dames Xvii Century	/org/national-society-colonial-dames-xvii-century-283
Holy Cross Center Inc	/org/holy-cross-center-inc
Story Park Board	/org/story-park-board
The Foundation For C A T C	/org/the-foundation-for-c-a-t-c
The Gillette Chamber Music Society	/org/the-gillette-chamber-music-society
Fossilfest Inc	/org/fossilfest-inc
Wyoming Health Council	/org/wyoming-health-council
Cornerstone Baptist Church	/org/cornerstone-baptist-church-53
Mt Carmel Mission Inc	/org/mt-carmel-mission-inc
The New Testament Apostolic Church Inc	/org/the-new-testament-apostolic-church-inc
Powell Community Bible Church	/org/powell-community-bible-church
Little League Baseball Inc	/org/little-league-baseball-inc-1264
Central Wyoming Hospice Program	/org/central-wyoming-hospice-program
Rendezvous Pointe	/org/rendezvous-pointe
Sunshine Corner Day Care Center	/org/sunshine-corner-day-care-center
Friends Of The Saratoga Branch Library	/org/friends-of-the-saratoga-branch-library
The United States Pony Clubs Inc	/org/the-united-states-pony-clubs-inc-207
Faith Fellowship	/org/faith-fellowship-14
Shepherd Of The Valley Lutheran Church	/org/shepherd-of-the-valley-lutheran-church-17
Weston County Hospital Joint Powers Board	/org/weston-county-hospital-joint-powers-board
Lander Church Of Christ	/org/lander-church-of-christ
The Wesley Foundation At The University Of Wyoming	/org/the-wesley-foundation-at-the-university-of-wyoming
Youth Alternative Home Association	/org/youth-alternative-home-association
Hot Springs County Senior Citizens Center Inc	/org/hot-springs-county-senior-citizens-center-inc
North Big Horn Senior Center Inc	/org/north-big-horn-senior-center-inc
Embroiderers Guild Of America Inc	/org/embroiderers-guild-of-america-inc-221
Luthercare Inc	/org/luthercare-inc
Fellowship Baptist Church	/org/fellowship-baptist-church-59
Manna Media Corporation	/org/manna-media-corporation
High Country Senior Citizens	/org/high-country-senior-citizens
Legacy Christian School	/org/legacy-christian-school
Pinedale Preschool Inc	/org/pinedale-preschool-inc
Albany County Public Library Foundation	/org/albany-county-public-library-foundation
Christian Life Church	/org/christian-life-church-18
Womens Self-Help Center Inc	/org/womens-self-help-center-inc
River Crossing	/org/river-crossing-1
Emerald Housing Inc	/org/emerald-housing-inc
Plumbers And Pipefitters Apprenticeship Education And Train	/org/plumbers-and-pipefitters-apprenticeship-education-and-train
First Apostolic Church Of Christ Of Laramie Wyoming Incorporated	/org/first-apostolic-church-of-christ-of-laramie-wyoming-incorporated
New Life Ministries Of Wyoming	/org/new-life-ministries-of-wyoming
Scottish Rite Foundation Of Wyoming	/org/scottish-rite-foundation-of-wyoming
Boy Scouts Of America	/org/boy-scouts-of-america-54
First Christian Church	/org/first-christian-church-943
GRAND TETON NATURAL HISTORY ASSOCIATION	/org/grand-teton-natural-history-association
Catholic Charities Of Wyoming Inc	/org/catholic-charities-of-wyoming-inc
Fort Laramie Historical Association	/org/fort-laramie-historical-association
Jackson Usa Wrestling Club	/org/jackson-usa-wrestling-club
Town Of Dubois Local Development Corporation	/org/town-of-dubois-local-development-corporation
Sweetwater County Library Foundation Inc	/org/sweetwater-county-library-foundation-inc
Institute For Ufo Contactee Studies	/org/institute-for-ufo-contactee-studies
Casper Day Care-Child Development Center, Inc. Trust	/org/casper-day-care-child-development-center-inc-trust
Genesis Foundation	/org/genesis-foundation-6
Sexual Assault Family Violence Educational Project	/org/sexual-assault-family-violence-educational-project
Evanston Child Development Center	/org/evanston-child-development-center
Faith Bible Chapel Of Casper	/org/faith-bible-chapel-of-casper-1
